team,visitor,tscore,vscore,gamespread,shorthome,shortvis,attendance
Memphis Grizzlies,Sacramento Kings,118,108,10,Grizzlies,Kings,0
Denver Nuggets,Boston Celtics,123,111,12,Nuggets,Celtics,0
Milwaukee Bucks,Washington Wizards,95,118,-23,Bucks,Wizards,0
New York Knicks,Phoenix Suns,102,83,19,Knicks,Suns,0
Philadelphia 76ers,New Orleans Pelicans,120,111,9,76ers,Pelicans,0
Charlotte Hornets,Los Angeles Lakers,115,121,-6,Hornets,Lakers,0
Indiana Pacers,Toronto Raptors,122,114,8,Pacers,Raptors,0
Cleveland Cavaliers,Chicago Bulls,145,134,11,Cavaliers,Bulls,0
Brooklyn Nets,San Antonio Spurs,139,103,36,Nets,Spurs,0
Minnesota Timberwolves,Denver Nuggets,124,111,13,Timberwolves,Nuggets,0
Houston Rockets,Dallas Mavericks,106,111,-5,Rockets,Mavericks,0
Portland Trail Blazers,Detroit Pistons,135,106,29,Blazers,Pistons,0
Golden State Warriors,Atlanta Hawks,143,141,2,Warriors,Hawks,0
LA Clippers,Miami Heat,100,110,-10,Clippers,Heat,0
Oklahoma City Thunder,Boston Celtics,150,117,33,Thunder,Celtics,0
Milwaukee Bucks,Washington Wizards,123,113,10,Bucks,Wizards,0
Utah Jazz,Sacramento Kings,115,117,-2,Jazz,Kings,0
Philadelphia 76ers,Indiana Pacers,129,126,3,76ers,Pacers,0
Cleveland Cavaliers,Phoenix Suns,90,88,2,Cavaliers,Suns,0
Charlotte Hornets,Memphis Grizzlies,107,131,-24,Hornets,Grizzlies,0
Orlando Magic,Oklahoma City Thunder,126,115,11,Magic,Thunder,0
New York Knicks,San Antonio Spurs,117,114,3,Knicks,Spurs,0
Toronto Raptors,Milwaukee Bucks,101,104,-3,Raptors,Bucks,0
Minnesota Timberwolves,Portland Trail Blazers,113,106,7,Timberwolves,Blazers,0
New Orleans Pelicans,Houston Rockets,119,108,11,Pelicans,Rockets,0
Chicago Bulls,Brooklyn Nets,121,112,9,Bulls,Nets,0
Los Angeles Lakers,Miami Heat,112,109,3,Lakers,Heat,0
Sacramento Kings,Atlanta Hawks,117,120,-3,Kings,Hawks,0
Golden State Warriors,Detroit Pistons,119,122,-3,Warriors,Pistons,0
Orlando Magic,Memphis Grizzlies,115,123,-8,Magic,Grizzlies,0
Dallas Mavericks,Boston Celtics,95,124,-29,Mavericks,Celtics,0
Houston Rockets,Utah Jazz,114,131,-17,Rockets,Jazz,0
Denver Nuggets,LA Clippers,122,91,31,Nuggets,Clippers,0
Indiana Pacers,Portland Trail Blazers,108,99,9,Pacers,Blazers,0
Philadelphia 76ers,Chicago Bulls,112,126,-14,76ers,Bulls,0
New Orleans Pelicans,Brooklyn Nets,102,108,-6,Pelicans,Nets,0
Toronto Raptors,New York Knicks,108,112,-4,Raptors,Knicks,0
San Antonio Spurs,Detroit Pistons,121,109,12,Spurs,Pistons,0
Milwaukee Bucks,Charlotte Hornets,109,138,-29,Bucks,Hornets,0
Oklahoma City Thunder,Washington Wizards,127,110,17,Thunder,Wizards,0
Minnesota Timberwolves,LA Clippers,128,115,13,Timberwolves,Clippers,0
Denver Nuggets,Cleveland Cavaliers,121,108,13,Nuggets,Cavaliers,0
Phoenix Suns,Miami Heat,96,104,-8,Suns,Heat,0
Los Angeles Lakers,Atlanta Hawks,130,114,16,Lakers,Hawks,0
San Antonio Spurs,Boston Celtics,116,121,-5,Spurs,Celtics,0
Dallas Mavericks,New Orleans Pelicans,127,117,10,Mavericks,Pelicans,0
Chicago Bulls,Utah Jazz,126,118,8,Bulls,Jazz,0
Golden State Warriors,Orlando Magic,101,115,-14,Warriors,Magic,0
Sacramento Kings,Los Angeles Lakers,134,136,-2,Kings,Lakers,0
Detroit Pistons,Philadelphia 76ers,111,123,-12,Pistons,76ers,0
Toronto Raptors,Portland Trail Blazers,117,105,12,Raptors,Blazers,0
Indiana Pacers,Charlotte Hornets,116,111,5,Pacers,Hornets,0
Memphis Grizzlies,Utah Jazz,123,118,5,Grizzlies,Jazz,0
Miami Heat,Brooklyn Nets,101,102,-1,Heat,Nets,0
Oklahoma City Thunder,Dallas Mavericks,120,109,11,Thunder,Mavericks,0
Houston Rockets,Minnesota Timberwolves,96,104,-8,Rockets,Timberwolves,0
Phoenix Suns,Cleveland Cavaliers,98,112,-14,Suns,Cavaliers,0
LA Clippers,Atlanta Hawks,108,112,-4,Clippers,Hawks,0
Washington Wizards,New Orleans Pelicans,112,132,-20,Wizards,Pelicans,0
New York Knicks,Milwaukee Bucks,107,111,-4,Knicks,Bucks,0
Boston Celtics,Chicago Bulls,107,99,8,Celtics,Bulls,0
Memphis Grizzlies,San Antonio Spurs,121,113,8,Grizzlies,Spurs,0
Denver Nuggets,Los Angeles Lakers,122,109,13,Nuggets,Lakers,0
Sacramento Kings,Orlando Magic,136,111,25,Kings,Magic,0
Philadelphia 76ers,Detroit Pistons,147,116,31,76ers,Pistons,0
Miami Heat,Oklahoma City Thunder,112,111,1,Heat,Thunder,0
Toronto Raptors,Charlotte Hornets,132,120,12,Raptors,Hornets,0
Utah Jazz,Cleveland Cavaliers,116,114,2,Jazz,Cavaliers,0
Portland Trail Blazers,Orlando Magic,106,109,-3,Blazers,Magic,0
Golden State Warriors,Phoenix Suns,113,125,-12,Warriors,Suns,0
LA Clippers,Dallas Mavericks,113,101,12,Clippers,Mavericks,0
Washington Wizards,Chicago Bulls,100,97,3,Wizards,Bulls,0
Detroit Pistons,Minnesota Timberwolves,135,118,17,Pistons,Timberwolves,0
New York Knicks,Indiana Pacers,119,113,6,Knicks,Pacers,0
Boston Celtics,New Orleans Pelicans,125,114,11,Celtics,Pelicans,0
Atlanta Hawks,Milwaukee Bucks,105,114,-9,Hawks,Bucks,0
Memphis Grizzlies,San Antonio Spurs,135,129,6,Grizzlies,Spurs,0
Denver Nuggets,Phoenix Suns,126,97,29,Nuggets,Suns,0
Sacramento Kings,Houston Rockets,135,115,20,Kings,Rockets,0
Philadelphia 76ers,Oklahoma City Thunder,114,133,-19,76ers,Thunder,0
Toronto Raptors,Charlotte Hornets,124,114,10,Raptors,Hornets,0
Brooklyn Nets,Boston Celtics,98,109,-11,Nets,Celtics,0
Miami Heat,Milwaukee Bucks,108,102,6,Heat,Bucks,0
Los Angeles Lakers,Dallas Mavericks,115,119,-4,Lakers,Mavericks,0
Portland Trail Blazers,Cleveland Cavaliers,113,119,-6,Blazers,Cavaliers,0
Washington Wizards,New York Knicks,108,112,-4,Wizards,Knicks,0
Detroit Pistons,New Orleans Pelicans,110,116,-6,Pistons,Pelicans,0
Indiana Pacers,Atlanta Hawks,111,113,-2,Pacers,Hawks,0
San Antonio Spurs,Golden State Warriors,113,144,-31,Spurs,Warriors,0
Minnesota Timberwolves,Phoenix Suns,121,116,5,Timberwolves,Suns,0
Chicago Bulls,Oklahoma City Thunder,110,124,-14,Bulls,Thunder,0
Utah Jazz,Orlando Magic,112,108,4,Jazz,Magic,0
LA Clippers,Denver Nuggets,103,115,-12,Clippers,Nuggets,0
Sacramento Kings,Houston Rockets,139,114,25,Kings,Rockets,0
Miami Heat,Milwaukee Bucks,111,95,16,Heat,Bucks,0
Indiana Pacers,Memphis Grizzlies,112,130,-18,Pacers,Grizzlies,0
Charlotte Hornets,Boston Celtics,106,122,-16,Hornets,Celtics,0
Toronto Raptors,Atlanta Hawks,103,114,-11,Raptors,Hawks,0
Minnesota Timberwolves,Cleveland Cavaliers,110,102,8,Timberwolves,Cavaliers,0
Utah Jazz,Philadelphia 76ers,117,118,-1,Jazz,76ers,0
Portland Trail Blazers,Dallas Mavericks,136,119,17,Blazers,Mavericks,0
Detroit Pistons,New York Knicks,104,117,-13,Pistons,Knicks,0
LA Clippers,Houston Rockets,121,100,21,Clippers,Rockets,0
Chicago Bulls,Golden State Warriors,132,118,14,Bulls,Warriors,0
Brooklyn Nets,Oklahoma City Thunder,102,112,-10,Nets,Thunder,0
San Antonio Spurs,Sacramento Kings,119,132,-13,Spurs,Kings,0
Denver Nuggets,Orlando Magic,119,116,3,Nuggets,Magic,0
Portland Trail Blazers,Dallas Mavericks,140,123,17,Blazers,Mavericks,0
Los Angeles Lakers,Philadelphia 76ers,112,113,-1,Lakers,76ers,0
Charlotte Hornets,Boston Celtics,118,130,-12,Hornets,Celtics,0
Milwaukee Bucks,Indiana Pacers,132,119,13,Bucks,Pacers,0
Washington Wizards,Golden State Warriors,118,127,-9,Wizards,Warriors,0
New York Knicks,Toronto Raptors,121,123,-2,Knicks,Raptors,0
Cleveland Cavaliers,New Orleans Pelicans,113,103,10,Cavaliers,Pelicans,0
Atlanta Hawks,Miami Heat,121,113,8,Hawks,Heat,0
Minnesota Timberwolves,Utah Jazz,125,126,-1,Timberwolves,Jazz,0
Memphis Grizzlies,Phoenix Suns,136,106,30,Grizzlies,Suns,0
Los Angeles Lakers,Houston Rockets,140,132,8,Lakers,Rockets,0
Milwaukee Bucks,Toronto Raptors,130,122,8,Bucks,Raptors,0
San Antonio Spurs,Brooklyn Nets,106,98,8,Spurs,Nets,0
Denver Nuggets,Portland Trail Blazers,122,113,9,Nuggets,Blazers,0
LA Clippers,Philadelphia 76ers,110,120,-10,Clippers,76ers,0
Dallas Mavericks,Atlanta Hawks,122,130,-8,Mavericks,Hawks,0
New York Knicks,Washington Wizards,105,116,-11,Knicks,Wizards,0
Oklahoma City Thunder,Indiana Pacers,126,106,20,Thunder,Pacers,0
Memphis Grizzlies,Cleveland Cavaliers,115,114,1,Grizzlies,Cavaliers,0
New Orleans Pelicans,Miami Heat,98,124,-26,Pelicans,Heat,0
Houston Rockets,Charlotte Hornets,117,122,-5,Rockets,Hornets,0
Utah Jazz,LA Clippers,126,103,23,Jazz,Clippers,0
Denver Nuggets,Minnesota Timberwolves,122,118,4,Nuggets,Timberwolves,0
Los Angeles Lakers,Sacramento Kings,111,116,-5,Lakers,Kings,0
Detroit Pistons,Chicago Bulls,108,126,-18,Pistons,Bulls,0
Boston Celtics,Golden State Warriors,121,118,3,Celtics,Warriors,0
Minnesota Timberwolves,Toronto Raptors,128,126,2,Timberwolves,Raptors,0
Portland Trail Blazers,Philadelphia 76ers,95,105,-10,Blazers,76ers,0
Phoenix Suns,Brooklyn Nets,117,112,5,Suns,Nets,0
Orlando Magic,New Orleans Pelicans,123,110,13,Magic,Pelicans,0
Cleveland Cavaliers,Golden State Warriors,114,120,-6,Cavaliers,Warriors,0
Dallas Mavericks,Miami Heat,115,90,25,Mavericks,Heat,0
Atlanta Hawks,New York Knicks,139,124,15,Hawks,Knicks,0
San Antonio Spurs,LA Clippers,126,131,-5,Spurs,Clippers,0
Utah Jazz,Brooklyn Nets,106,117,-11,Jazz,Nets,0
Denver Nuggets,Indiana Pacers,134,111,23,Nuggets,Pacers,0
Sacramento Kings,Oklahoma City Thunder,118,113,5,Kings,Thunder,0
Los Angeles Lakers,Memphis Grizzlies,122,121,1,Lakers,Grizzlies,0
Toronto Raptors,Boston Celtics,104,106,-2,Raptors,Celtics,0
Washington Wizards,Orlando Magic,138,118,20,Wizards,Magic,0
Atlanta Hawks,Charlotte Hornets,118,122,-4,Hawks,Hornets,0
Cleveland Cavaliers,Milwaukee Bucks,114,102,12,Cavaliers,Bucks,0
Minnesota Timberwolves,Houston Rockets,113,104,9,Timberwolves,Rockets,0
Phoenix Suns,Indiana Pacers,112,107,5,Suns,Pacers,0
Sacramento Kings,Philadelphia 76ers,127,129,-2,Kings,76ers,0
Dallas Mavericks,LA Clippers,98,112,-14,Mavericks,Clippers,0
Miami Heat,New Orleans Pelicans,100,96,4,Heat,Pelicans,0
Toronto Raptors,New York Knicks,125,116,9,Raptors,Knicks,0
Phoenix Suns,Memphis Grizzlies,112,110,2,Suns,Grizzlies,0
Denver Nuggets,Oklahoma City Thunder,99,101,-2,Nuggets,Thunder,0
Golden State Warriors,Brooklyn Nets,116,120,-4,Warriors,Nets,0
Portland Trail Blazers,Los Angeles Lakers,112,121,-9,Blazers,Lakers,0
Orlando Magic,Boston Celtics,113,98,15,Magic,Celtics,0
Detroit Pistons,Milwaukee Bucks,130,150,-20,Pistons,Bucks,0
Houston Rockets,Minnesota Timberwolves,119,114,5,Rockets,Timberwolves,0
Chicago Bulls,Atlanta Hawks,111,100,11,Bulls,Hawks,0
Utah Jazz,Charlotte Hornets,120,102,18,Jazz,Hornets,0
Portland Trail Blazers,San Antonio Spurs,147,127,20,Blazers,Spurs,0
Sacramento Kings,Memphis Grizzlies,133,100,33,Kings,Grizzlies,0
Indiana Pacers,Chicago Bulls,116,110,6,Pacers,Bulls,0
Miami Heat,Boston Celtics,98,95,3,Heat,Celtics,0
New York Knicks,Cleveland Cavaliers,105,103,2,Knicks,Cavaliers,0
New Orleans Pelicans,Denver Nuggets,98,99,-1,Pelicans,Nuggets,0
Dallas Mavericks,Washington Wizards,126,127,-1,Mavericks,Wizards,0
Phoenix Suns,Charlotte Hornets,128,97,31,Suns,Hornets,0
Los Angeles Lakers,LA Clippers,115,133,-18,Lakers,Clippers,0
Orlando Magic,Indiana Pacers,126,120,6,Magic,Pacers,0
Philadelphia 76ers,Brooklyn Nets,137,133,4,76ers,Nets,0
Houston Rockets,Washington Wizards,103,108,-5,Rockets,Wizards,0
Milwaukee Bucks,Denver Nuggets,107,99,8,Bucks,Nuggets,0
Oklahoma City Thunder,Atlanta Hawks,132,137,-5,Thunder,Hawks,0
New Orleans Pelicans,Minnesota Timberwolves,102,111,-9,Pelicans,Timberwolves,0
Portland Trail Blazers,Utah Jazz,134,124,10,Blazers,Jazz,0
Sacramento Kings,Toronto Raptors,95,113,-18,Kings,Raptors,0
Golden State Warriors,Memphis Grizzlies,122,120,2,Warriors,Grizzlies,0
Los Angeles Lakers,San Antonio Spurs,113,104,9,Lakers,Spurs,0
Brooklyn Nets,Detroit Pistons,122,130,-8,Nets,Pistons,0
Boston Celtics,New York Knicks,117,120,-3,Celtics,Knicks,0
Charlotte Hornets,Chicago Bulls,111,96,15,Hornets,Bulls,0
Houston Rockets,Cleveland Cavaliers,95,113,-18,Rockets,Cavaliers,0
Phoenix Suns,Dallas Mavericks,95,99,-4,Suns,Mavericks,0
LA Clippers,San Antonio Spurs,138,100,38,Clippers,Spurs,0
Indiana Pacers,Milwaukee Bucks,131,141,-10,Pacers,Bucks,0
Minnesota Timberwolves,Memphis Grizzlies,111,100,11,Timberwolves,Grizzlies,0
Miami Heat,Orlando Magic,110,105,5,Heat,Magic,0
Oklahoma City Thunder,Cleveland Cavaliers,112,100,12,Thunder,Cavaliers,0
Golden State Warriors,Toronto Raptors,129,117,12,Warriors,Raptors,0
Philadelphia 76ers,Denver Nuggets,126,119,7,76ers,Nuggets,0
Brooklyn Nets,New York Knicks,122,115,7,Nets,Knicks,0
Orlando Magic,Chicago Bulls,109,128,-19,Magic,Bulls,0
Detroit Pistons,Houston Rockets,114,117,-3,Pistons,Rockets,0
Atlanta Hawks,LA Clippers,113,120,-7,Hawks,Clippers,0
Minnesota Timberwolves,Sacramento Kings,117,110,7,Timberwolves,Kings,0
San Antonio Spurs,Phoenix Suns,118,128,-10,Spurs,Suns,0
New Orleans Pelicans,Washington Wizards,103,113,-10,Pelicans,Wizards,0
Boston Celtics,Los Angeles Lakers,125,121,4,Celtics,Lakers,0
Utah Jazz,Dallas Mavericks,108,100,8,Jazz,Mavericks,0
Portland Trail Blazers,Toronto Raptors,105,123,-18,Blazers,Raptors,0
Charlotte Hornets,Miami Heat,122,117,5,Hornets,Heat,0
Memphis Grizzlies,Indiana Pacers,112,100,12,Grizzlies,Pacers,0
Cleveland Cavaliers,LA Clippers,122,99,23,Cavaliers,Clippers,0
Milwaukee Bucks,New Orleans Pelicans,135,110,25,Bucks,Pelicans,0
Philadelphia 76ers,Orlando Magic,109,119,-10,76ers,Magic,0
Brooklyn Nets,Los Angeles Lakers,121,104,17,Nets,Lakers,0
San Antonio Spurs,Washington Wizards,106,127,-21,Spurs,Wizards,0
Minnesota Timberwolves,Sacramento Kings,111,118,-7,Timberwolves,Kings,0
Oklahoma City Thunder,Golden State Warriors,120,128,-8,Thunder,Warriors,0
Dallas Mavericks,Detroit Pistons,111,105,6,Mavericks,Pistons,0
Phoenix Suns,Toronto Raptors,114,106,8,Suns,Raptors,0
Portland Trail Blazers,Atlanta Hawks,129,125,4,Blazers,Hawks,0
Cleveland Cavaliers,Miami Heat,97,100,-3,Cavaliers,Heat,0
New York Knicks,Los Angeles Lakers,123,129,-6,Knicks,Lakers,0
Chicago Bulls,LA Clippers,103,108,-5,Bulls,Clippers,0
Milwaukee Bucks,Charlotte Hornets,124,115,9,Bucks,Hornets,0
Denver Nuggets,New Orleans Pelicans,122,113,9,Nuggets,Pelicans,0
Philadelphia 76ers,Orlando Magic,105,94,11,76ers,Magic,0
Detroit Pistons,Washington Wizards,N/A,N/A,#VALUE!,Pistons,Wizards,0
Memphis Grizzlies,Portland Trail Blazers,112,122,-10,Grizzlies,Blazers,0
Boston Celtics,Brooklyn Nets,139,96,43,Celtics,Nets,0
Minnesota Timberwolves,Golden State Warriors,119,114,5,Timberwolves,Warriors,0
Houston Rockets,Oklahoma City Thunder,112,106,6,Rockets,Thunder,0
San Antonio Spurs,Sacramento Kings,109,119,-10,Spurs,Kings,0
Utah Jazz,Toronto Raptors,131,128,3,Jazz,Raptors,0
Phoenix Suns,Atlanta Hawks,100,132,-32,Suns,Hawks,0
Indiana Pacers,Los Angeles Lakers,111,112,-1,Pacers,Lakers,0
New York Knicks,Miami Heat,106,104,2,Knicks,Heat,0
Cleveland Cavaliers,Memphis Grizzlies,128,113,15,Cavaliers,Grizzlies,0
Chicago Bulls,Charlotte Hornets,114,98,16,Bulls,Hornets,0
Dallas Mavericks,New Orleans Pelicans,111,106,5,Mavericks,Pelicans,0
Denver Nuggets,Golden State Warriors,134,117,17,Nuggets,Warriors,0
Milwaukee Bucks,LA Clippers,106,105,1,Bucks,Clippers,0
Detroit Pistons,Charlotte Hornets,118,112,6,Pistons,Hornets,0
Washington Wizards,Portland Trail Blazers,116,124,-8,Wizards,Blazers,0
Indiana Pacers,Sacramento Kings,107,104,3,Pacers,Kings,0
Boston Celtics,Phoenix Suns,94,106,-12,Celtics,Suns,0
San Antonio Spurs,Philadelphia 76ers,125,137,-12,Spurs,76ers,0
Minnesota Timberwolves,Orlando Magic,120,127,-7,Timberwolves,Magic,0
Houston Rockets,Toronto Raptors,111,117,-6,Rockets,Raptors,0
Utah Jazz,Atlanta Hawks,108,115,-7,Jazz,Hawks,0
New Orleans Pelicans,Los Angeles Lakers,131,126,5,Pelicans,Lakers,0
Brooklyn Nets,Washington Wizards,125,123,2,Nets,Wizards,0
Detroit Pistons,Phoenix Suns,100,116,-16,Pistons,Suns,0
New York Knicks,LA Clippers,128,134,-6,Knicks,Clippers,0
Chicago Bulls,Portland Trail Blazers,129,121,8,Bulls,Blazers,0
Oklahoma City Thunder,Houston Rockets,153,121,32,Thunder,Rockets,0
Milwaukee Bucks,Miami Heat,123,115,8,Bucks,Heat,0
Golden State Warriors,Dallas Mavericks,119,113,6,Warriors,Mavericks,0
Denver Nuggets,Atlanta Hawks,128,108,20,Nuggets,Hawks,0
Charlotte Hornets,Orlando Magic,113,119,-6,Hornets,Magic,0
Indiana Pacers,Cleveland Cavaliers,103,122,-19,Pacers,Cavaliers,0
New York Knicks,Philadelphia 76ers,108,97,11,Knicks,76ers,0
Memphis Grizzlies,Toronto Raptors,103,106,-3,Grizzlies,Raptors,0
New Orleans Pelicans,Sacramento Kings,136,104,32,Pelicans,Kings,0
Minnesota Timberwolves,Denver Nuggets,128,98,30,Timberwolves,Nuggets,0
Detroit Pistons,Boston Celtics,99,111,-12,Pistons,Celtics,0
Washington Wizards,Cleveland Cavaliers,91,114,-23,Wizards,Cavaliers,0
Brooklyn Nets,LA Clippers,116,124,-8,Nets,Clippers,0
Chicago Bulls,San Antonio Spurs,128,104,24,Bulls,Spurs,0
Houston Rockets,Sacramento Kings,120,140,-20,Rockets,Kings,0
Utah Jazz,Dallas Mavericks,111,124,-13,Jazz,Mavericks,0
Golden State Warriors,Oklahoma City Thunder,141,114,27,Warriors,Thunder,0
Portland Trail Blazers,Milwaukee Bucks,108,127,-19,Blazers,Bucks,0
Orlando Magic,New York Knicks,98,102,-4,Magic,Knicks,0
New Orleans Pelicans,Atlanta Hawks,116,107,9,Pelicans,Hawks,0
Brooklyn Nets,Phoenix Suns,112,116,-4,Nets,Suns,0
Memphis Grizzlies,Chicago Bulls,104,89,15,Grizzlies,Bulls,0
Denver Nuggets,Minnesota Timberwolves,146,112,34,Nuggets,Timberwolves,0
Los Angeles Lakers,Oklahoma City Thunder,130,133,-3,Lakers,Thunder,0
Washington Wizards,Charlotte Hornets,118,104,14,Wizards,Hornets,0
Cleveland Cavaliers,Detroit Pistons,113,85,28,Cavaliers,Pistons,0
Boston Celtics,Philadelphia 76ers,106,99,7,Celtics,76ers,0
Toronto Raptors,San Antonio Spurs,112,98,14,Raptors,Spurs,0
Miami Heat,Indiana Pacers,116,111,5,Heat,Pacers,0
Houston Rockets,Sacramento Kings,128,130,-2,Rockets,Kings,0
Utah Jazz,Minnesota Timberwolves,118,143,-25,Jazz,Timberwolves,0
LA Clippers,Dallas Mavericks,104,110,-6,Clippers,Mavericks,0
Portland Trail Blazers,Golden State Warriors,125,122,3,Blazers,Warriors,0
Orlando Magic,Denver Nuggets,115,104,11,Magic,Nuggets,0
Atlanta Hawks,Phoenix Suns,116,107,9,Hawks,Suns,0
Brooklyn Nets,Chicago Bulls,116,105,11,Nets,Bulls,0
Los Angeles Lakers,Milwaukee Bucks,106,115,-9,Lakers,Bucks,0
Indiana Pacers,Phoenix Suns,104,117,-13,Pacers,Suns,0
Philadelphia 76ers,New York Knicks,119,108,11,76ers,Knicks,0
Detroit Pistons,San Antonio Spurs,138,131,7,Pistons,Spurs,0
Toronto Raptors,Utah Jazz,116,122,-6,Raptors,Jazz,0
Boston Celtics,Charlotte Hornets,127,116,11,Celtics,Hornets,0
Miami Heat,Houston Rockets,97,95,2,Heat,Rockets,0
Memphis Grizzlies,Minnesota Timberwolves,128,107,21,Grizzlies,Timberwolves,0
New Orleans Pelicans,Cleveland Cavaliers,107,118,-11,Pelicans,Cavaliers,0
Portland Trail Blazers,Oklahoma City Thunder,129,138,-9,Blazers,Thunder,0
Sacramento Kings,Dallas Mavericks,114,122,-8,Kings,Mavericks,0
LA Clippers,Milwaukee Bucks,106,119,-13,Clippers,Bucks,0
Brooklyn Nets,Philadelphia 76ers,98,101,-3,Nets,76ers,0
Charlotte Hornets,Denver Nuggets,105,119,-14,Hornets,Nuggets,0
Washington Wizards,Indiana Pacers,127,113,14,Wizards,Pacers,0
Orlando Magic,Miami Heat,103,107,-4,Magic,Heat,0
New York Knicks,Utah Jazz,126,120,6,Knicks,Jazz,0
Atlanta Hawks,San Antonio Spurs,125,106,19,Hawks,Spurs,0
Cleveland Cavaliers,Chicago Bulls,97,89,8,Cavaliers,Bulls,0
Golden State Warriors,Los Angeles Lakers,103,109,-6,Warriors,Lakers,0
Sacramento Kings,Dallas Mavericks,133,128,5,Kings,Mavericks,0
Boston Celtics,Memphis Grizzlies,119,109,10,Celtics,Grizzlies,0
Toronto Raptors,Detroit Pistons,119,118,1,Raptors,Pistons,0
Charlotte Hornets,Atlanta Hawks,144,138,6,Hornets,Hawks,0
Cleveland Cavaliers,San Antonio Spurs,117,109,8,Cavaliers,Spurs,0
Philadelphia 76ers,Houston Rockets,123,104,19,76ers,Rockets,0
Indiana Pacers,Utah Jazz,117,123,-6,Pacers,Jazz,0
New York Knicks,Brooklyn Nets,124,106,18,Knicks,Nets,0
Miami Heat,Denver Nuggets,108,112,-4,Heat,Nuggets,0
Chicago Bulls,Orlando Magic,91,100,-9,Bulls,Magic,0
Oklahoma City Thunder,New Orleans Pelicans,100,103,-3,Thunder,Pelicans,0
Dallas Mavericks,Minnesota Timberwolves,121,124,-3,Mavericks,Timberwolves,0
Portland Trail Blazers,Los Angeles Lakers,127,115,12,Blazers,Lakers,0
Golden State Warriors,Washington Wizards,135,126,9,Warriors,Wizards,0
Milwaukee Bucks,Boston Celtics,131,125,6,Bucks,Celtics,0
Toronto Raptors,Orlando Magic,123,113,10,Raptors,Magic,0
Phoenix Suns,Sacramento Kings,120,109,11,Suns,Kings,0
Portland Trail Blazers,Washington Wizards,101,126,-25,Blazers,Wizards,0
LA Clippers,Golden State Warriors,134,124,10,Clippers,Warriors,0
Indiana Pacers,Chicago Bulls,117,113,4,Pacers,Bulls,0
Charlotte Hornets,San Antonio Spurs,120,110,10,Hornets,Spurs,0
Atlanta Hawks,New York Knicks,101,122,-21,Hawks,Knicks,0
Brooklyn Nets,Miami Heat,116,105,11,Nets,Heat,0
Boston Celtics,Detroit Pistons,127,109,18,Celtics,Pistons,0
Philadelphia 76ers,Cleveland Cavaliers,118,112,6,76ers,Cavaliers,0
Oklahoma City Thunder,Houston Rockets,133,96,37,Thunder,Rockets,0
Memphis Grizzlies,Utah Jazz,117,111,6,Grizzlies,Jazz,0
Denver Nuggets,Dallas Mavericks,118,109,9,Nuggets,Mavericks,0
Los Angeles Lakers,New Orleans Pelicans,120,102,18,Lakers,Pelicans,0
Chicago Bulls,Milwaukee Bucks,100,112,-12,Bulls,Bucks,0
Minnesota Timberwolves,Washington Wizards,106,114,-8,Timberwolves,Wizards,0
Phoenix Suns,LA Clippers,107,116,-9,Suns,Clippers,0
Orlando Magic,Detroit Pistons,108,106,2,Magic,Pistons,0
Cleveland Cavaliers,Denver Nuggets,109,115,-6,Cavaliers,Nuggets,0
Philadelphia 76ers,Memphis Grizzlies,110,105,5,76ers,Grizzlies,0
Toronto Raptors,New Orleans Pelicans,115,110,5,Raptors,Pelicans,0
Dallas Mavericks,San Antonio Spurs,142,116,26,Mavericks,Spurs,0
Utah Jazz,Oklahoma City Thunder,120,119,1,Jazz,Thunder,0
Los Angeles Lakers,Golden State Warriors,124,111,13,Lakers,Warriors,0
Sacramento Kings,Portland Trail Blazers,133,116,17,Kings,Blazers,0
Washington Wizards,New York Knicks,109,115,-6,Wizards,Knicks,0
Milwaukee Bucks,Miami Heat,128,99,29,Bucks,Heat,0
Atlanta Hawks,Cleveland Cavaliers,136,119,17,Hawks,Cavaliers,0
Chicago Bulls,Brooklyn Nets,131,87,44,Bulls,Nets,0
Minnesota Timberwolves,Charlotte Hornets,113,121,-8,Timberwolves,Hornets,0
Golden State Warriors,Houston Rockets,116,101,15,Warriors,Rockets,0
Phoenix Suns,Oklahoma City Thunder,124,115,9,Suns,Thunder,0
LA Clippers,Sacramento Kings,175,176,-1,Clippers,Kings,0
Detroit Pistons,Toronto Raptors,91,95,-4,Pistons,Raptors,0
Orlando Magic,Indiana Pacers,108,121,-13,Magic,Pacers,0
Charlotte Hornets,Miami Heat,108,103,5,Hornets,Heat,0
New York Knicks,New Orleans Pelicans,128,106,22,Knicks,Pelicans,0
Memphis Grizzlies,Denver Nuggets,112,94,18,Grizzlies,Nuggets,0
Philadelphia 76ers,Boston Celtics,107,110,-3,76ers,Celtics,0
Utah Jazz,San Antonio Spurs,118,102,16,Jazz,Spurs,0
Milwaukee Bucks,Phoenix Suns,104,101,3,Bucks,Suns,0
Atlanta Hawks,Brooklyn Nets,129,127,2,Hawks,Nets,0
Dallas Mavericks,Los Angeles Lakers,108,111,-3,Mavericks,Lakers,0
Chicago Bulls,Washington Wizards,102,82,20,Bulls,Wizards,0
Cleveland Cavaliers,Toronto Raptors,118,93,25,Cavaliers,Raptors,0
Oklahoma City Thunder,Sacramento Kings,115,124,-9,Thunder,Kings,0
Golden State Warriors,Minnesota Timberwolves,109,104,5,Warriors,Timberwolves,0
Portland Trail Blazers,Houston Rockets,131,114,17,Blazers,Rockets,0
Denver Nuggets,LA Clippers,134,124,10,Nuggets,Clippers,0
Charlotte Hornets,Detroit Pistons,117,106,11,Hornets,Pistons,0
Philadelphia 76ers,Miami Heat,99,101,-2,76ers,Heat,0
New York Knicks,Boston Celtics,109,94,15,Knicks,Celtics,0
New Orleans Pelicans,Orlando Magic,93,101,-8,Pelicans,Magic,0
Toronto Raptors,Chicago Bulls,104,98,6,Raptors,Bulls,0
Atlanta Hawks,Washington Wizards,116,119,-3,Hawks,Wizards,0
Brooklyn Nets,Milwaukee Bucks,104,118,-14,Nets,Bucks,0
Memphis Grizzlies,Los Angeles Lakers,121,109,12,Grizzlies,Lakers,0
Houston Rockets,Denver Nuggets,112,133,-21,Rockets,Nuggets,0
Oklahoma City Thunder,Sacramento Kings,117,123,-6,Thunder,Kings,0
Dallas Mavericks,Indiana Pacers,122,124,-2,Mavericks,Pacers,0
Utah Jazz,San Antonio Spurs,94,102,-8,Jazz,Spurs,0
LA Clippers,Minnesota Timberwolves,101,108,-7,Clippers,Timberwolves,0
Golden State Warriors,Portland Trail Blazers,123,105,18,Warriors,Blazers,0
Detroit Pistons,Chicago Bulls,115,117,-2,Pistons,Bulls,0
Charlotte Hornets,Phoenix Suns,91,105,-14,Hornets,Suns,0
New York Knicks,Brooklyn Nets,142,118,24,Knicks,Nets,0
Miami Heat,Philadelphia 76ers,96,119,-23,Heat,76ers,0
Boston Celtics,Cleveland Cavaliers,117,113,4,Celtics,Cavaliers,0
Milwaukee Bucks,Orlando Magic,139,117,22,Bucks,Magic,0
Houston Rockets,Memphis Grizzlies,99,113,-14,Rockets,Grizzlies,0
Oklahoma City Thunder,Los Angeles Lakers,117,123,-6,Thunder,Lakers,0
Portland Trail Blazers,New Orleans Pelicans,110,121,-11,Blazers,Pelicans,0
Washington Wizards,Toronto Raptors,119,108,11,Wizards,Raptors,0
Dallas Mavericks,Philadelphia 76ers,133,126,7,Mavericks,76ers,0
San Antonio Spurs,Indiana Pacers,110,99,11,Spurs,Pacers,0
Golden State Warriors,LA Clippers,115,91,24,Warriors,Clippers,0
Charlotte Hornets,Orlando Magic,106,117,-11,Hornets,Magic,0
Atlanta Hawks,Portland Trail Blazers,129,111,18,Hawks,Blazers,0
Boston Celtics,Brooklyn Nets,105,115,-10,Celtics,Nets,0
Miami Heat,New York Knicks,120,122,-2,Heat,Knicks,0
Chicago Bulls,Phoenix Suns,104,125,-21,Bulls,Suns,0
Oklahoma City Thunder,Utah Jazz,130,103,27,Thunder,Jazz,0
Sacramento Kings,LA Clippers,128,127,1,Kings,Clippers,0
Denver Nuggets,Memphis Grizzlies,113,97,16,Nuggets,Grizzlies,0
Golden State Warriors,New Orleans Pelicans,108,99,9,Warriors,Pelicans,0
Los Angeles Lakers,Minnesota Timberwolves,102,110,-8,Lakers,Timberwolves,0
Washington Wizards,Toronto Raptors,109,116,-7,Wizards,Raptors,0
Cleveland Cavaliers,Detroit Pistons,114,90,24,Cavaliers,Pistons,0
San Antonio Spurs,Houston Rockets,110,122,-12,Spurs,Rockets,0
Miami Heat,Atlanta Hawks,117,109,8,Heat,Hawks,0
Milwaukee Bucks,Philadelphia 76ers,130,133,-3,Bucks,76ers,0
Sacramento Kings,Minnesota Timberwolves,134,138,-4,Kings,Timberwolves,0
Dallas Mavericks,Phoenix Suns,126,130,-4,Mavericks,Suns,0
Chicago Bulls,Indiana Pacers,122,125,-3,Bulls,Pacers,0
Los Angeles Lakers,Golden State Warriors,113,105,8,Lakers,Warriors,0
Brooklyn Nets,Charlotte Hornets,102,86,16,Nets,Hornets,0
Orlando Magic,Portland Trail Blazers,119,122,-3,Magic,Blazers,0
Oklahoma City Thunder,Utah Jazz,129,119,10,Thunder,Jazz,0
Houston Rockets,San Antonio Spurs,142,110,32,Rockets,Spurs,0
Washington Wizards,Milwaukee Bucks,111,117,-6,Wizards,Bucks,0
Boston Celtics,New York Knicks,129,131,-2,Celtics,Knicks,0
LA Clippers,Memphis Grizzlies,135,129,6,Clippers,Grizzlies,0
Cleveland Cavaliers,Boston Celtics,118,114,4,Cavaliers,Celtics,0
Detroit Pistons,Portland Trail Blazers,104,110,-6,Pistons,Blazers,0
Indiana Pacers,Philadelphia 76ers,143,147,-4,Pacers,76ers,0
Miami Heat,Atlanta Hawks,130,128,2,Heat,Hawks,0
Denver Nuggets,Toronto Raptors,118,113,5,Nuggets,Raptors,0
Sacramento Kings,New Orleans Pelicans,123,108,15,Kings,Pelicans,0
Orlando Magic,Milwaukee Bucks,123,134,-11,Magic,Bucks,0
Detroit Pistons,Washington Wizards,117,119,-2,Pistons,Wizards,0
Minnesota Timberwolves,Philadelphia 76ers,94,117,-23,Timberwolves,76ers,0
New York Knicks,Charlotte Hornets,105,112,-7,Knicks,Hornets,0
Houston Rockets,Brooklyn Nets,96,118,-22,Rockets,Nets,0
Oklahoma City Thunder,Golden State Warriors,137,128,9,Thunder,Warriors,0
Dallas Mavericks,Utah Jazz,120,116,4,Mavericks,Jazz,0
Los Angeles Lakers,Memphis Grizzlies,112,103,9,Lakers,Grizzlies,0
Washington Wizards,Atlanta Hawks,120,122,-2,Wizards,Hawks,0
Miami Heat,Cleveland Cavaliers,100,104,-4,Heat,Cavaliers,0
New Orleans Pelicans,Dallas Mavericks,113,106,7,Pelicans,Mavericks,0
Boston Celtics,Portland Trail Blazers,115,93,22,Celtics,Blazers,0
Denver Nuggets,Chicago Bulls,96,117,-21,Nuggets,Bulls,0
Phoenix Suns,Oklahoma City Thunder,132,101,31,Suns,Thunder,0
LA Clippers,Toronto Raptors,108,100,8,Clippers,Raptors,0
Indiana Pacers,Houston Rockets,134,125,9,Pacers,Rockets,0
Detroit Pistons,Charlotte Hornets,103,113,-10,Pistons,Hornets,0
Orlando Magic,Utah Jazz,124,131,-7,Magic,Jazz,0
Memphis Grizzlies,Golden State Warriors,131,110,21,Grizzlies,Warriors,0
Milwaukee Bucks,Brooklyn Nets,118,113,5,Bucks,Nets,0
Sacramento Kings,New York Knicks,122,117,5,Kings,Knicks,0
Philadelphia 76ers,Portland Trail Blazers,120,119,1,76ers,Blazers,0
Washington Wizards,Atlanta Hawks,107,114,-7,Wizards,Hawks,0
Minnesota Timberwolves,Brooklyn Nets,123,124,-1,Timberwolves,Nets,0
Miami Heat,Cleveland Cavaliers,119,115,4,Heat,Cavaliers,0
San Antonio Spurs,Denver Nuggets,128,120,8,Spurs,Nuggets,0
Los Angeles Lakers,Toronto Raptors,122,112,10,Lakers,Raptors,0
LA Clippers,New York Knicks,106,95,11,Clippers,Knicks,0
Charlotte Hornets,Utah Jazz,111,119,-8,Hornets,Jazz,0
Detroit Pistons,Indiana Pacers,115,121,-6,Pistons,Pacers,0
Orlando Magic,Miami Heat,126,114,12,Magic,Heat,0
Atlanta Hawks,Boston Celtics,125,134,-9,Hawks,Celtics,0
Houston Rockets,Chicago Bulls,111,119,-8,Rockets,Bulls,0
Memphis Grizzlies,Dallas Mavericks,112,108,4,Grizzlies,Mavericks,0
Golden State Warriors,Milwaukee Bucks,125,116,9,Warriors,Bucks,0
New Orleans Pelicans,Oklahoma City Thunder,96,110,-14,Pelicans,Thunder,0
Phoenix Suns,Sacramento Kings,119,128,-9,Suns,Kings,0
Denver Nuggets,Brooklyn Nets,120,122,-2,Nuggets,Nets,0
Charlotte Hornets,Cleveland Cavaliers,108,114,-6,Hornets,Cavaliers,0
Philadelphia 76ers,Washington Wizards,112,93,19,76ers,Wizards,0
New Orleans Pelicans,Portland Trail Blazers,127,110,17,Pelicans,Blazers,0
San Antonio Spurs,Oklahoma City Thunder,90,102,-12,Spurs,Thunder,0
Los Angeles Lakers,New York Knicks,108,112,-4,Lakers,Knicks,0
Detroit Pistons,Indiana Pacers,117,97,20,Pistons,Pacers,0
Dallas Mavericks,Memphis Grizzlies,88,104,-16,Mavericks,Grizzlies,0
Miami Heat,Utah Jazz,119,115,4,Heat,Jazz,0
Atlanta Hawks,Minnesota Timberwolves,115,136,-21,Hawks,Timberwolves,0
Houston Rockets,Boston Celtics,111,109,2,Rockets,Celtics,0
Golden State Warriors,Phoenix Suns,123,112,11,Warriors,Suns,0
Sacramento Kings,Milwaukee Bucks,124,133,-9,Kings,Bucks,0
Charlotte Hornets,Cleveland Cavaliers,104,120,-16,Hornets,Cavaliers,0
Washington Wizards,Detroit Pistons,117,97,20,Wizards,Pistons,0
Toronto Raptors,Denver Nuggets,125,110,15,Raptors,Nuggets,0
San Antonio Spurs,Orlando Magic,132,114,18,Spurs,Magic,0
New Orleans Pelicans,Los Angeles Lakers,108,123,-15,Pelicans,Lakers,0
Oklahoma City Thunder,Brooklyn Nets,121,107,14,Thunder,Nets,0
Portland Trail Blazers,New York Knicks,107,123,-16,Blazers,Knicks,0
Phoenix Suns,Milwaukee Bucks,104,116,-12,Suns,Bucks,0
Cleveland Cavaliers,Philadelphia 76ers,109,118,-9,Cavaliers,76ers,0
Miami Heat,Memphis Grizzlies,138,119,19,Heat,Grizzlies,0
Minnesota Timberwolves,Boston Celtics,102,104,-2,Timberwolves,Celtics,0
Chicago Bulls,Sacramento Kings,114,117,-3,Bulls,Kings,0
Houston Rockets,Los Angeles Lakers,114,110,4,Rockets,Lakers,0
San Antonio Spurs,Dallas Mavericks,128,137,-9,Spurs,Mavericks,0
LA Clippers,Golden State Warriors,134,126,8,Clippers,Warriors,0
Detroit Pistons,Denver Nuggets,100,119,-19,Pistons,Nuggets,0
Brooklyn Nets,Sacramento Kings,96,101,-5,Nets,Kings,0
Toronto Raptors,Oklahoma City Thunder,128,111,17,Raptors,Thunder,0
Milwaukee Bucks,Indiana Pacers,123,139,-16,Bucks,Pacers,0
Phoenix Suns,Orlando Magic,116,113,3,Suns,Magic,0
Charlotte Hornets,Philadelphia 76ers,82,121,-39,Hornets,76ers,0
Atlanta Hawks,Golden State Warriors,127,119,8,Hawks,Warriors,0
Cleveland Cavaliers,Washington Wizards,117,94,23,Cavaliers,Wizards,0
Houston Rockets,New Orleans Pelicans,114,112,2,Rockets,Pelicans,0
San Antonio Spurs,Memphis Grizzlies,120,126,-6,Spurs,Grizzlies,0
Chicago Bulls,Minnesota Timberwolves,139,131,8,Bulls,Timberwolves,0
Portland Trail Blazers,Boston Celtics,112,126,-14,Blazers,Celtics,0
Los Angeles Lakers,Dallas Mavericks,110,111,-1,Lakers,Mavericks,0
New York Knicks,Denver Nuggets,116,110,6,Knicks,Nuggets,0
LA Clippers,Orlando Magic,108,113,-5,Clippers,Magic,0
Indiana Pacers,Philadelphia 76ers,121,141,-20,Pacers,76ers,0
Toronto Raptors,Minnesota Timberwolves,122,107,15,Raptors,Timberwolves,0
Washington Wizards,Sacramento Kings,118,132,-14,Wizards,Kings,0
Memphis Grizzlies,Golden State Warriors,133,119,14,Grizzlies,Warriors,0
Chicago Bulls,Miami Heat,113,99,14,Bulls,Heat,0
Utah Jazz,Boston Celtics,118,117,1,Jazz,Celtics,0
Brooklyn Nets,Denver Nuggets,102,108,-6,Nets,Nuggets,0
Oklahoma City Thunder,Phoenix Suns,124,120,4,Thunder,Suns,0
San Antonio Spurs,Atlanta Hawks,126,118,8,Spurs,Hawks,0
Detroit Pistons,Miami Heat,100,112,-12,Pistons,Heat,0
Houston Rockets,New Orleans Pelicans,107,117,-10,Rockets,Pelicans,0
Milwaukee Bucks,Toronto Raptors,118,111,7,Bucks,Raptors,0
Portland Trail Blazers,LA Clippers,102,117,-15,Blazers,Clippers,0
Los Angeles Lakers,Orlando Magic,111,105,6,Lakers,Magic,0
Charlotte Hornets,Indiana Pacers,115,109,6,Hornets,Pacers,0
Philadelphia 76ers,Chicago Bulls,105,109,-4,76ers,Bulls,0
New York Knicks,Minnesota Timberwolves,134,140,-6,Knicks,Timberwolves,0
Houston Rockets,Golden State Warriors,108,121,-13,Rockets,Warriors,0
Memphis Grizzlies,Dallas Mavericks,112,108,4,Grizzlies,Mavericks,0
Utah Jazz,Sacramento Kings,128,120,8,Jazz,Kings,0
Orlando Magic,Washington Wizards,122,112,10,Magic,Wizards,0
Atlanta Hawks,Detroit Pistons,129,107,22,Hawks,Pistons,0
Brooklyn Nets,Cleveland Cavaliers,109,115,-6,Nets,Cavaliers,0
New Orleans Pelicans,San Antonio Spurs,119,84,35,Pelicans,Spurs,0
Sacramento Kings,Boston Celtics,109,132,-23,Kings,Celtics,0
LA Clippers,Oklahoma City Thunder,100,101,-1,Clippers,Thunder,0
Washington Wizards,Denver Nuggets,104,118,-14,Wizards,Nuggets,0
Dallas Mavericks,Golden State Warriors,125,127,-2,Mavericks,Warriors,0
Toronto Raptors,Indiana Pacers,114,118,-4,Raptors,Pacers,0
Miami Heat,New York Knicks,127,120,7,Heat,Knicks,0
Milwaukee Bucks,San Antonio Spurs,130,94,36,Bucks,Spurs,0
Memphis Grizzlies,Houston Rockets,130,125,5,Grizzlies,Rockets,0
Chicago Bulls,Philadelphia 76ers,91,116,-25,Bulls,76ers,0
Minnesota Timberwolves,Atlanta Hawks,125,124,1,Timberwolves,Hawks,0
Utah Jazz,Portland Trail Blazers,115,127,-12,Jazz,Blazers,0
Los Angeles Lakers,Phoenix Suns,122,111,11,Lakers,Suns,0
Orlando Magic,New York Knicks,111,106,5,Magic,Knicks,0
Brooklyn Nets,Cleveland Cavaliers,114,116,-2,Nets,Cavaliers,0
New Orleans Pelicans,Charlotte Hornets,115,96,19,Pelicans,Hornets,0
LA Clippers,Oklahoma City Thunder,127,105,22,Clippers,Thunder,0
Washington Wizards,San Antonio Spurs,136,124,12,Wizards,Spurs,0
Boston Celtics,Indiana Pacers,120,95,25,Celtics,Pacers,0
Toronto Raptors,Detroit Pistons,118,97,21,Raptors,Pistons,0
Memphis Grizzlies,Houston Rockets,151,114,37,Grizzlies,Rockets,0
Dallas Mavericks,Charlotte Hornets,109,117,-8,Mavericks,Hornets,0
Utah Jazz,Milwaukee Bucks,116,144,-28,Jazz,Bucks,0
Golden State Warriors,Philadelphia 76ers,120,112,8,Warriors,76ers,0
Sacramento Kings,Phoenix Suns,135,127,8,Kings,Suns,0
Portland Trail Blazers,Chicago Bulls,96,124,-28,Blazers,Bulls,0
Los Angeles Lakers,Oklahoma City Thunder,116,111,5,Lakers,Thunder,0
Atlanta Hawks,Indiana Pacers,143,130,13,Hawks,Pacers,0
Miami Heat,Brooklyn Nets,100,129,-29,Heat,Nets,0
Denver Nuggets,Milwaukee Bucks,129,106,23,Nuggets,Bucks,0
Sacramento Kings,Utah Jazz,121,113,8,Kings,Jazz,0
Phoenix Suns,Philadelphia 76ers,125,105,20,Suns,76ers,0
LA Clippers,New Orleans Pelicans,110,131,-21,Clippers,Pelicans,0
Charlotte Hornets,Dallas Mavericks,110,104,6,Hornets,Mavericks,0
Los Angeles Lakers,Chicago Bulls,108,118,-10,Lakers,Bulls,0
Cleveland Cavaliers,Houston Rockets,108,91,17,Cavaliers,Rockets,0
Toronto Raptors,Washington Wizards,114,104,10,Raptors,Wizards,0
Boston Celtics,San Antonio Spurs,137,93,44,Celtics,Spurs,0
Atlanta Hawks,Memphis Grizzlies,119,123,-4,Hawks,Grizzlies,0
Orlando Magic,Brooklyn Nets,119,106,13,Magic,Nets,0
Portland Trail Blazers,Oklahoma City Thunder,112,118,-6,Blazers,Thunder,0
Golden State Warriors,Minnesota Timberwolves,96,99,-3,Warriors,Timberwolves,0
Indiana Pacers,Dallas Mavericks,104,127,-23,Pacers,Mavericks,0
Detroit Pistons,Milwaukee Bucks,117,126,-9,Pistons,Bucks,0
New York Knicks,Houston Rockets,137,115,22,Knicks,Rockets,0
Utah Jazz,Phoenix Suns,103,117,-14,Jazz,Suns,0
Denver Nuggets,Philadelphia 76ers,116,111,5,Nuggets,76ers,0
Portland Trail Blazers,New Orleans Pelicans,90,124,-34,Blazers,Pelicans,0
Sacramento Kings,Minnesota Timberwolves,115,119,-4,Kings,Timberwolves,0
LA Clippers,Chicago Bulls,124,112,12,Clippers,Bulls,0
Washington Wizards,Boston Celtics,130,111,19,Wizards,Celtics,0
Atlanta Hawks,Cleveland Cavaliers,120,118,2,Hawks,Cavaliers,0
Toronto Raptors,Miami Heat,106,92,14,Raptors,Heat,0
Memphis Grizzlies,Orlando Magic,113,108,5,Grizzlies,Magic,0
Oklahoma City Thunder,Charlotte Hornets,134,137,-3,Thunder,Hornets,0
Golden State Warriors,New Orleans Pelicans,120,109,11,Warriors,Pelicans,0
Indiana Pacers,Milwaukee Bucks,136,149,-13,Pacers,Bucks,0
Brooklyn Nets,Houston Rockets,123,114,9,Nets,Rockets,0
Philadelphia 76ers,Dallas Mavericks,116,108,8,76ers,Mavericks,0
New York Knicks,Miami Heat,101,92,9,Knicks,Heat,0
Chicago Bulls,Los Angeles Lakers,110,121,-11,Bulls,Lakers,0
San Antonio Spurs,Utah Jazz,117,128,-11,Spurs,Jazz,0
Memphis Grizzlies,LA Clippers,132,141,-9,Grizzlies,Clippers,0
Oklahoma City Thunder,Detroit Pistons,107,106,1,Thunder,Pistons,0
Portland Trail Blazers,Sacramento Kings,80,120,-40,Blazers,Kings,0
Phoenix Suns,Minnesota Timberwolves,107,100,7,Suns,Timberwolves,0
Milwaukee Bucks,Boston Celtics,99,140,-41,Bucks,Celtics,0
Denver Nuggets,New Orleans Pelicans,88,107,-19,Nuggets,Pelicans,0
Charlotte Hornets,Chicago Bulls,91,121,-30,Hornets,Bulls,0
Philadelphia 76ers,Toronto Raptors,117,110,7,76ers,Raptors,0
Washington Wizards,Orlando Magic,109,116,-7,Wizards,Magic,0
Indiana Pacers,Oklahoma City Thunder,121,117,4,Pacers,Thunder,0
Cleveland Cavaliers,New York Knicks,116,130,-14,Cavaliers,Knicks,0
Brooklyn Nets,Atlanta Hawks,124,107,17,Nets,Hawks,0
Boston Celtics,Utah Jazz,122,114,8,Celtics,Jazz,0
Minnesota Timberwolves,Los Angeles Lakers,111,123,-12,Timberwolves,Lakers,0
Houston Rockets,Detroit Pistons,121,115,6,Rockets,Pistons,0
Memphis Grizzlies,LA Clippers,108,94,14,Grizzlies,Clippers,0
Portland Trail Blazers,Sacramento Kings,114,138,-24,Blazers,Kings,0
Golden State Warriors,San Antonio Spurs,130,115,15,Warriors,Spurs,0
Phoenix Suns,Denver Nuggets,100,93,7,Suns,Nuggets,0
Miami Heat,Dallas Mavericks,129,122,7,Heat,Mavericks,0
New Orleans Pelicans,LA Clippers,122,114,8,Pelicans,Clippers,0
Charlotte Hornets,Toronto Raptors,108,128,-20,Hornets,Raptors,0
Minnesota Timberwolves,Portland Trail Blazers,105,107,-2,Timberwolves,Blazers,0
Brooklyn Nets,Utah Jazz,111,110,1,Nets,Jazz,0
Chicago Bulls,Memphis Grizzlies,128,107,21,Bulls,Grizzlies,0
New York Knicks,Washington Wizards,118,109,9,Knicks,Wizards,0
Orlando Magic,Detroit Pistons,128,102,26,Magic,Pistons,0
Sacramento Kings,San Antonio Spurs,134,142,-8,Kings,Spurs,0
Atlanta Hawks,Dallas Mavericks,132,130,2,Hawks,Mavericks,0
Houston Rockets,Los Angeles Lakers,109,134,-25,Rockets,Lakers,0
Oklahoma City Thunder,Phoenix Suns,118,128,-10,Thunder,Suns,0
Cleveland Cavaliers,Indiana Pacers,115,105,10,Cavaliers,Pacers,0
Milwaukee Bucks,Philadelphia 76ers,117,104,13,Bucks,76ers,0
Denver Nuggets,Golden State Warriors,112,110,2,Nuggets,Warriors,0
Orlando Magic,Cleveland Cavaliers,113,117,-4,Magic,Cavaliers,0
Charlotte Hornets,Toronto Raptors,100,120,-20,Hornets,Raptors,0
Washington Wizards,Milwaukee Bucks,128,140,-12,Wizards,Bucks,0
Detroit Pistons,Miami Heat,105,118,-13,Pistons,Heat,0
Brooklyn Nets,Minnesota Timberwolves,102,107,-5,Nets,Timberwolves,0
Houston Rockets,Denver Nuggets,124,103,21,Rockets,Nuggets,0
Chicago Bulls,Atlanta Hawks,105,123,-18,Bulls,Hawks,0
Memphis Grizzlies,Portland Trail Blazers,119,109,10,Grizzlies,Blazers,0
Philadelphia 76ers,Boston Celtics,103,101,2,76ers,Celtics,0
New Orleans Pelicans,Sacramento Kings,103,121,-18,Pelicans,Kings,0
Utah Jazz,Los Angeles Lakers,133,135,-2,Jazz,Lakers,0
Golden State Warriors,Oklahoma City Thunder,136,125,11,Warriors,Thunder,0
Phoenix Suns,San Antonio Spurs,115,94,21,Suns,Spurs,0
Indiana Pacers,New York Knicks,129,138,-9,Pacers,Knicks,0
Detroit Pistons,Brooklyn Nets,108,123,-15,Pistons,Nets,0
Atlanta Hawks,Washington Wizards,134,116,18,Hawks,Wizards,0
Milwaukee Bucks,Chicago Bulls,105,92,13,Bucks,Bulls,0
Boston Celtics,Toronto Raptors,97,93,4,Celtics,Raptors,0
New Orleans Pelicans,Memphis Grizzlies,138,131,7,Pelicans,Grizzlies,0
Dallas Mavericks,Sacramento Kings,123,119,4,Mavericks,Kings,0
LA Clippers,Los Angeles Lakers,125,118,7,Clippers,Lakers,0
Orlando Magic,Cleveland Cavaliers,94,118,-24,Magic,Cavaliers,0
Philadelphia 76ers,Miami Heat,101,129,-28,76ers,Heat,0
San Antonio Spurs,Portland Trail Blazers,129,127,2,Spurs,Blazers,0
Utah Jazz,Oklahoma City Thunder,98,114,-16,Jazz,Thunder,0
Phoenix Suns,Denver Nuggets,119,115,4,Suns,Nuggets,0
Charlotte Hornets,Houston Rockets,109,112,-3,Hornets,Rockets,0
Washington Wizards,Miami Heat,114,108,6,Wizards,Heat,0
Indiana Pacers,Detroit Pistons,115,122,-7,Pacers,Pistons,0
Brooklyn Nets,Orlando Magic,101,84,17,Nets,Magic,0
Boston Celtics,Toronto Raptors,121,102,19,Celtics,Raptors,0
Atlanta Hawks,Philadelphia 76ers,131,136,-5,Hawks,76ers,0
Milwaukee Bucks,Memphis Grizzlies,114,137,-23,Bucks,Grizzlies,0
New Orleans Pelicans,New York Knicks,113,105,8,Pelicans,Knicks,0
Dallas Mavericks,Chicago Bulls,112,115,-3,Mavericks,Bulls,0
Sacramento Kings,Golden State Warriors,97,119,-22,Kings,Warriors,0
Los Angeles Lakers,Phoenix Suns,121,107,14,Lakers,Suns,0
Utah Jazz,Denver Nuggets,118,114,4,Jazz,Nuggets,0
LA Clippers,Portland Trail Blazers,136,125,11,Clippers,Blazers,0
San Antonio Spurs,Minnesota Timberwolves,131,151,-20,Spurs,Timberwolves,0
New York Knicks,Indiana Pacers,136,141,-5,Knicks,Pacers,0
Cleveland Cavaliers,Charlotte Hornets,95,106,-11,Cavaliers,Hornets,0
Toronto Raptors,Milwaukee Bucks,121,105,16,Raptors,Bucks,0
Washington Wizards,Houston Rockets,109,114,-5,Wizards,Rockets,0
Brooklyn Nets,Philadelphia 76ers,105,134,-29,Nets,76ers,0
Boston Celtics,Atlanta Hawks,120,114,6,Celtics,Hawks,0
Chicago Bulls,Detroit Pistons,103,81,22,Bulls,Pistons,0
Miami Heat,Orlando Magic,123,110,13,Heat,Magic,0
Los Angeles Lakers,Utah Jazz,128,117,11,Lakers,Jazz,0
Dallas Mavericks,San Antonio Spurs,117,138,-21,Mavericks,Spurs,0
Oklahoma City Thunder,Memphis Grizzlies,115,100,15,Thunder,Grizzlies,0
Denver Nuggets,Sacramento Kings,109,95,14,Nuggets,Kings,0
Phoenix Suns,LA Clippers,114,119,-5,Suns,Clippers,0
Portland Trail Blazers,Golden State Warriors,101,157,-56,Blazers,Warriors,0
Minnesota Timberwolves,New Orleans Pelicans,113,108,5,Timberwolves,Pelicans,0
Miami Heat,Atlanta Hawks,105,116,-11,Heat,Hawks,0
Los Angeles Lakers,Minnesota Timberwolves,108,102,6,Lakers,Timberwolves,0
Toronto Raptors,Chicago Bulls,105,109,-4,Raptors,Bulls,0
New Orleans Pelicans,Oklahoma City Thunder,118,123,-5,Pelicans,Thunder,0
Miami Heat,Chicago Bulls,102,91,11,Heat,Bulls,0
Minnesota Timberwolves,Oklahoma City Thunder,120,95,25,Timberwolves,Thunder,0
Philadelphia 76ers,Brooklyn Nets,121,101,20,76ers,Nets,0
Boston Celtics,Atlanta Hawks,112,99,13,Celtics,Hawks,0
Cleveland Cavaliers,New York Knicks,97,101,-4,Cavaliers,Knicks,0
Sacramento Kings,Golden State Warriors,126,123,3,Kings,Warriors,0
Memphis Grizzlies,Los Angeles Lakers,112,128,-16,Grizzlies,Lakers,0
Milwaukee Bucks,Miami Heat,117,130,-13,Bucks,Heat,0
Phoenix Suns,LA Clippers,110,115,-5,Suns,Clippers,0
Denver Nuggets,Minnesota Timberwolves,109,80,29,Nuggets,Timberwolves,0
Philadelphia 76ers,Brooklyn Nets,96,84,12,76ers,Nets,0
Sacramento Kings,Golden State Warriors,114,106,8,Kings,Warriors,0
Boston Celtics,Atlanta Hawks,119,106,13,Celtics,Hawks,0
Cleveland Cavaliers,New York Knicks,107,90,17,Cavaliers,Knicks,0
Phoenix Suns,LA Clippers,123,109,14,Suns,Clippers,0
Memphis Grizzlies,Los Angeles Lakers,103,93,10,Grizzlies,Lakers,0
Milwaukee Bucks,Miami Heat,138,122,16,Bucks,Heat,0
Denver Nuggets,Minnesota Timberwolves,122,113,9,Nuggets,Timberwolves,0
Brooklyn Nets,Philadelphia 76ers,97,102,-5,Nets,76ers,0
Golden State Warriors,Sacramento Kings,114,97,17,Warriors,Kings,0
LA Clippers,Phoenix Suns,124,129,-5,Clippers,Suns,0
Atlanta Hawks,Boston Celtics,130,122,8,Hawks,Celtics,0
New York Knicks,Cleveland Cavaliers,99,79,20,Knicks,Cavaliers,0
Minnesota Timberwolves,Denver Nuggets,111,120,-9,Timberwolves,Nuggets,0
Brooklyn Nets,Philadelphia 76ers,88,96,-8,Nets,76ers,0
LA Clippers,Phoenix Suns,100,112,-12,Clippers,Suns,0
Miami Heat,Milwaukee Bucks,121,99,22,Heat,Bucks,0
Los Angeles Lakers,Memphis Grizzlies,111,101,10,Lakers,Grizzlies,0
New York Knicks,Cleveland Cavaliers,102,93,9,Knicks,Cavaliers,0
Golden State Warriors,Sacramento Kings,126,125,1,Warriors,Kings,0
Atlanta Hawks,Boston Celtics,121,129,-8,Hawks,Celtics,0
Minnesota Timberwolves,Denver Nuggets,114,108,6,Timberwolves,Nuggets,0
Philadelphia 76ers,Brooklyn Nets,N/A,N/A,#VALUE!,76ers,Nets,0
Miami Heat,Milwaukee Bucks,119,114,5,Heat,Bucks,0
Los Angeles Lakers,Memphis Grizzlies,117,111,6,Lakers,Grizzlies,0
Boston Celtics,Atlanta Hawks,117,119,-2,Celtics,Hawks,0
Denver Nuggets,Minnesota Timberwolves,112,109,3,Nuggets,Timberwolves,0
Phoenix Suns,LA Clippers,136,130,6,Suns,Clippers,0
Cleveland Cavaliers,New York Knicks,95,106,-11,Cavaliers,Knicks,0
Memphis Grizzlies,Los Angeles Lakers,116,99,17,Grizzlies,Lakers,0
Milwaukee Bucks,Miami Heat,126,128,-2,Bucks,Heat,0
Sacramento Kings,Golden State Warriors,116,123,-7,Kings,Warriors,0
Brooklyn Nets,Philadelphia 76ers,N/A,N/A,#VALUE!,Nets,76ers,0
Minnesota Timberwolves,Denver Nuggets,N/A,N/A,#VALUE!,Timberwolves,Nuggets,0
LA Clippers,Phoenix Suns,N/A,N/A,#VALUE!,Clippers,Suns,0
Atlanta Hawks,Boston Celtics,120,128,-8,Hawks,Celtics,0
New York Knicks,Cleveland Cavaliers,N/A,N/A,#VALUE!,Knicks,Cavaliers,0
Miami Heat,Milwaukee Bucks,N/A,N/A,#VALUE!,Heat,Bucks,0
Golden State Warriors,Sacramento Kings,99,118,-19,Warriors,Kings,0
Los Angeles Lakers,Memphis Grizzlies,125,85,40,Lakers,Grizzlies,0
Denver Nuggets,Minnesota Timberwolves,N/A,N/A,#VALUE!,Nuggets,Timberwolves,0
Phoenix Suns,LA Clippers,N/A,N/A,#VALUE!,Suns,Clippers,0
Philadelphia 76ers,Brooklyn Nets,N/A,N/A,#VALUE!,76ers,Nets,0
Boston Celtics,Atlanta Hawks,N/A,N/A,#VALUE!,Celtics,Hawks,0
Denver Nuggets,Phoenix Suns,125,107,18,Nuggets,Suns,0
Cleveland Cavaliers,New York Knicks,N/A,N/A,#VALUE!,Cavaliers,Knicks,0
New York Knicks,Miami Heat,101,108,-7,Knicks,Heat,0
Memphis Grizzlies,Los Angeles Lakers,N/A,N/A,#VALUE!,Grizzlies,Lakers,0
Milwaukee Bucks,Miami Heat,N/A,N/A,#VALUE!,Bucks,Heat,0
Sacramento Kings,Golden State Warriors,100,120,-20,Kings,Warriors,0
Boston Celtics,Philadelphia 76ers,115,119,-4,Celtics,76ers,0
Denver Nuggets,Phoenix Suns,97,87,10,Nuggets,Suns,0
New York Knicks,Miami Heat,111,105,6,Knicks,Heat,0
Golden State Warriors,Los Angeles Lakers,112,117,-5,Warriors,Lakers,0
Boston Celtics,Philadelphia 76ers,121,87,34,Celtics,76ers,0
Golden State Warriors,Los Angeles Lakers,127,100,27,Warriors,Lakers,0
Philadelphia 76ers,Boston Celtics,102,114,-12,76ers,Celtics,0
Phoenix Suns,Denver Nuggets,121,114,7,Suns,Nuggets,0
Miami Heat,New York Knicks,105,86,19,Heat,Knicks,0
Los Angeles Lakers,Golden State Warriors,127,97,30,Lakers,Warriors,0
Philadelphia 76ers,Boston Celtics,116,115,1,76ers,Celtics,0
Phoenix Suns,Denver Nuggets,129,124,5,Suns,Nuggets,0
Miami Heat,New York Knicks,109,101,8,Heat,Knicks,0
Los Angeles Lakers,Golden State Warriors,104,101,3,Lakers,Warriors,0
Boston Celtics,Philadelphia 76ers,103,115,-12,Celtics,76ers,0
Denver Nuggets,Phoenix Suns,118,102,16,Nuggets,Suns,0
New York Knicks,Miami Heat,112,103,9,Knicks,Heat,0
Golden State Warriors,Los Angeles Lakers,121,106,15,Warriors,Lakers,0
Philadelphia 76ers,Boston Celtics,86,95,-9,76ers,Celtics,0
Phoenix Suns,Denver Nuggets,100,125,-25,Suns,Nuggets,0
Miami Heat,New York Knicks,96,92,4,Heat,Knicks,0
Los Angeles Lakers,Golden State Warriors,122,101,21,Lakers,Warriors,0
Golden State Warriors,Los Angeles Lakers,N/A,N/A,#VALUE!,Warriors,Lakers,0
Denver Nuggets,Phoenix Suns,N/A,N/A,#VALUE!,Nuggets,Suns,0
Boston Celtics,Philadelphia 76ers,112,88,24,Celtics,76ers,0
New York Knicks,Miami Heat,N/A,N/A,#VALUE!,Knicks,Heat,0
Denver Nuggets,Los Angeles Lakers,132,126,6,Nuggets,Lakers,0
Boston Celtics,Miami Heat,116,123,-7,Celtics,Heat,0
Denver Nuggets,Los Angeles Lakers,108,103,5,Nuggets,Lakers,0
Boston Celtics,Miami Heat,105,111,-6,Celtics,Heat,0
Los Angeles Lakers,Denver Nuggets,108,119,-11,Lakers,Nuggets,0
Miami Heat,Boston Celtics,128,102,26,Heat,Celtics,0
Los Angeles Lakers,Denver Nuggets,111,113,-2,Lakers,Nuggets,0
Miami Heat,Boston Celtics,99,116,-17,Heat,Celtics,0
Denver Nuggets,Los Angeles Lakers,N/A,N/A,#VALUE!,Nuggets,Lakers,0
Boston Celtics,Miami Heat,110,97,13,Celtics,Heat,0
Los Angeles Lakers,Denver Nuggets,N/A,N/A,#VALUE!,Lakers,Nuggets,0
Miami Heat,Boston Celtics,103,104,-1,Heat,Celtics,0
Denver Nuggets,Los Angeles Lakers,N/A,N/A,#VALUE!,Nuggets,Lakers,0
Boston Celtics,Miami Heat,84,103,-19,Celtics,Heat,0
Denver Nuggets,Miami Heat,104,93,11,Nuggets,Heat,0
Denver Nuggets,Miami Heat,108,111,-3,Nuggets,Heat,0
Miami Heat,Denver Nuggets,94,109,-15,Heat,Nuggets,0
Miami Heat,Denver Nuggets,95,108,-13,Heat,Nuggets,0
Denver Nuggets,Miami Heat,94,89,5,Nuggets,Heat,0
Miami Heat,Denver Nuggets,N/A,N/A,#VALUE!,Heat,Nuggets,0
Denver Nuggets,Miami Heat,N/A,N/A,#VALUE!,Nuggets,Heat,0
Minnesota Timberwolves,Dallas Mavericks,111,99,12,Timberwolves,Mavericks,0
Dallas Mavericks,Minnesota Timberwolves,96,104,-8,Mavericks,Timberwolves,0
Golden State Warriors,Los Angeles Lakers,125,108,17,Warriors,Lakers,0
Milwaukee Bucks,Chicago Bulls,105,102,3,Bucks,Bulls,0
Detroit Pistons,Phoenix Suns,126,130,-4,Pistons,Suns,0
Boston Celtics,Philadelphia 76ers,114,106,8,Celtics,76ers,0
Toronto Raptors,Sacramento Kings,112,99,13,Raptors,Kings,0
Memphis Grizzlies,Indiana Pacers,127,122,5,Grizzlies,Pacers,0
LA Clippers,Utah Jazz,96,101,-5,Clippers,Jazz,0
New York Knicks,Boston Celtics,114,107,7,Knicks,Celtics,0
Oklahoma City Thunder,San Antonio Spurs,122,121,1,Thunder,Spurs,0
Los Angeles Lakers,Brooklyn Nets,129,126,3,Lakers,Nets,0
Washington Wizards,Cairns Taipans,145,82,63,Wizards,Taipans,0
Miami Heat,Charlotte Hornets,113,109,4,Heat,Hornets,0
Atlanta Hawks,Cleveland Cavaliers,108,107,1,Hawks,Cavaliers,0
New Orleans Pelicans,Orlando Magic,105,122,-17,Pelicans,Magic,0
Memphis Grizzlies,Milwaukee Bucks,108,102,6,Grizzlies,Bucks,0
Houston Rockets,Indiana Pacers,122,103,19,Rockets,Pacers,0
Phoenix Suns,Denver Nuggets,107,115,-8,Suns,Nuggets,0
Portland Trail Blazers,New Zealand Breakers,106,66,40,Blazers,Breakers,0
LA Clippers,Utah Jazz,103,98,5,Clippers,Jazz,0
Philadelphia 76ers,Boston Celtics,101,112,-11,76ers,Celtics,0
Los Angeles Lakers,Sacramento Kings,109,101,8,Lakers,Kings,0
Cleveland Cavaliers,Orlando Magic,105,108,-3,Cavaliers,Magic,0
Oklahoma City Thunder,Detroit Pistons,125,128,-3,Thunder,Pistons,0
Washington Wizards,Charlotte Hornets,98,92,6,Wizards,Hornets,0
Atlanta Hawks,Memphis Grizzlies,103,102,1,Hawks,Grizzlies,0
Brooklyn Nets,Maccabi Ra'anana,135,103,32,Nets,Ra'anana,0
New Orleans Pelicans,Houston Rockets,87,120,-33,Pelicans,Rockets,0
Chicago Bulls,Denver Nuggets,133,124,9,Bulls,Nuggets,0
Portland Trail Blazers,Phoenix Suns,111,122,-11,Blazers,Suns,0
San Antonio Spurs,Miami Heat,120,104,16,Spurs,Heat,0
Los Angeles Lakers,Golden State Warriors,125,129,-4,Lakers,Warriors,0
Atlanta Hawks,New Orleans Pelicans,110,105,5,Hawks,Pelicans,0
New York Knicks,Minnesota Timberwolves,112,121,-9,Knicks,Timberwolves,0
Utah Jazz,Portland Trail Blazers,138,133,5,Jazz,Blazers,0
Charlotte Hornets,Oklahoma City Thunder,117,115,2,Hornets,Thunder,0
Toronto Raptors,Cairns Taipans,134,93,41,Raptors,Taipans,0
Miami Heat,Memphis Grizzlies,132,124,8,Heat,Grizzlies,0
Los Angeles Lakers,Milwaukee Bucks,97,108,-11,Lakers,Bucks,0
Denver Nuggets,Chicago Bulls,116,102,14,Nuggets,Bulls,0
Sacramento Kings,Golden State Warriors,115,121,-6,Kings,Warriors,0
Cleveland Cavaliers,Maccabi Ra'anana,120,89,31,Cavaliers,Ra'anana,0
Indiana Pacers,Atlanta Hawks,116,112,4,Pacers,Hawks,0
Brooklyn Nets,Philadelphia 76ers,119,127,-8,Nets,76ers,0
San Antonio Spurs,Houston Rockets,89,99,-10,Spurs,Rockets,0
Utah Jazz,New Zealand Breakers,114,94,20,Jazz,Breakers,0
Phoenix Suns,Portland Trail Blazers,117,106,11,Suns,Blazers,0
Orlando Magic,New Orleans Pelicans,92,104,-12,Magic,Pelicans,0
Boston Celtics,New York Knicks,123,110,13,Celtics,Knicks,0
Oklahoma City Thunder,Milwaukee Bucks,124,101,23,Thunder,Bucks,0
Chicago Bulls,Toronto Raptors,102,106,-4,Bulls,Raptors,0
Minnesota Timberwolves,Maccabi Ra'anana,138,111,27,Timberwolves,Ra'anana,0
LA Clippers,Denver Nuggets,116,103,13,Clippers,Nuggets,0
New York Knicks,Washington Wizards,106,131,-25,Knicks,Wizards,0
Miami Heat,Brooklyn Nets,104,107,-3,Heat,Nets,0
San Antonio Spurs,Houston Rockets,117,103,14,Spurs,Rockets,0
Golden State Warriors,Sacramento Kings,116,115,1,Warriors,Kings,0
Charlotte Hornets,Boston Celtics,99,127,-28,Hornets,Celtics,0
Chicago Bulls,Minnesota Timberwolves,105,114,-9,Bulls,Timberwolves,0
Oklahoma City Thunder,Detroit Pistons,116,118,-2,Thunder,Pistons,0
Los Angeles Lakers,Phoenix Suns,100,123,-23,Lakers,Suns,0
Sacramento Kings,Utah Jazz,116,113,3,Kings,Jazz,0
LA Clippers,Denver Nuggets,90,103,-13,Clippers,Nuggets,0
Orlando Magic,Flamengo Flamengo,109,76,33,Magic,Flamengo,0
Philadelphia 76ers,Atlanta Hawks,120,106,14,76ers,Hawks,0
Indiana Pacers,Cleveland Cavaliers,109,104,5,Pacers,Cavaliers,0
Toronto Raptors,Washington Wizards,134,98,36,Raptors,Wizards,0
Dallas Mavericks,Detroit Pistons,114,104,10,Mavericks,Pistons,0
Milwaukee Bucks,Memphis Grizzlies,124,116,8,Bucks,Grizzlies,0
Houston Rockets,Miami Heat,110,104,6,Rockets,Heat,0
Golden State Warriors,San Antonio Spurs,117,122,-5,Warriors,Spurs,0
Denver Nuggets,Los Angeles Lakers,119,107,12,Nuggets,Lakers,0
Golden State Warriors,Phoenix Suns,104,108,-4,Warriors,Suns,0
Charlotte Hornets,Atlanta Hawks,116,110,6,Hornets,Hawks,0
Indiana Pacers,Washington Wizards,143,120,23,Pacers,Wizards,0
New York Knicks,Boston Celtics,104,108,-4,Knicks,Celtics,0
Orlando Magic,Houston Rockets,116,86,30,Magic,Rockets,0
Toronto Raptors,Minnesota Timberwolves,97,94,3,Raptors,Timberwolves,0
Miami Heat,Detroit Pistons,103,102,1,Heat,Pistons,0
Brooklyn Nets,Cleveland Cavaliers,113,114,-1,Nets,Cavaliers,0
Memphis Grizzlies,New Orleans Pelicans,104,111,-7,Grizzlies,Pelicans,0
Chicago Bulls,Oklahoma City Thunder,104,124,-20,Bulls,Thunder,0
Utah Jazz,Sacramento Kings,114,130,-16,Jazz,Kings,0
San Antonio Spurs,Dallas Mavericks,119,126,-7,Spurs,Mavericks,0
LA Clippers,Portland Trail Blazers,123,111,12,Clippers,Blazers,0
Milwaukee Bucks,Philadelphia 76ers,118,117,1,Bucks,76ers,0
Los Angeles Lakers,Phoenix Suns,100,95,5,Lakers,Suns,0
Memphis Grizzlies,Denver Nuggets,104,108,-4,Grizzlies,Nuggets,0
Charlotte Hornets,Detroit Pistons,99,111,-12,Hornets,Pistons,0
Atlanta Hawks,New York Knicks,120,126,-6,Hawks,Knicks,0
Boston Celtics,Miami Heat,119,111,8,Celtics,Heat,0
Cleveland Cavaliers,Oklahoma City Thunder,105,108,-3,Cavaliers,Thunder,0
San Antonio Spurs,Houston Rockets,126,122,4,Spurs,Rockets,0
Chicago Bulls,Toronto Raptors,104,103,1,Bulls,Raptors,0
Dallas Mavericks,Brooklyn Nets,125,120,5,Mavericks,Nets,0
Utah Jazz,LA Clippers,120,118,2,Jazz,Clippers,0
Portland Trail Blazers,Orlando Magic,97,102,-5,Blazers,Magic,0
Sacramento Kings,Golden State Warriors,114,122,-8,Kings,Warriors,0
New Orleans Pelicans,New York Knicks,96,87,9,Pelicans,Knicks,0
Detroit Pistons,Chicago Bulls,118,102,16,Pistons,Bulls,0
Washington Wizards,Memphis Grizzlies,113,106,7,Wizards,Grizzlies,0
Cleveland Cavaliers,Indiana Pacers,113,125,-12,Cavaliers,Pacers,0
Toronto Raptors,Philadelphia 76ers,107,114,-7,Raptors,76ers,0
Minnesota Timberwolves,Miami Heat,106,90,16,Timberwolves,Heat,0
Phoenix Suns,Utah Jazz,126,104,22,Suns,Jazz,0
Oklahoma City Thunder,Denver Nuggets,95,128,-33,Thunder,Nuggets,0
Milwaukee Bucks,Atlanta Hawks,110,127,-17,Bucks,Hawks,0
Houston Rockets,Golden State Warriors,95,106,-11,Rockets,Warriors,0
Philadelphia 76ers,Portland Trail Blazers,126,98,28,76ers,Blazers,0
Sacramento Kings,Los Angeles Lakers,132,127,5,Kings,Lakers,0
LA Clippers,San Antonio Spurs,123,83,40,Clippers,Spurs,0
Washington Wizards,Boston Celtics,107,126,-19,Wizards,Celtics,0
Indiana Pacers,Chicago Bulls,105,112,-7,Pacers,Bulls,0
Charlotte Hornets,Brooklyn Nets,121,133,-12,Hornets,Nets,0
Toronto Raptors,Portland Trail Blazers,91,99,-8,Raptors,Blazers,0
Atlanta Hawks,Minnesota Timberwolves,127,113,14,Hawks,Timberwolves,0
Oklahoma City Thunder,Detroit Pistons,124,112,12,Thunder,Pistons,0
Memphis Grizzlies,Dallas Mavericks,110,125,-15,Grizzlies,Mavericks,0
New Orleans Pelicans,Golden State Warriors,102,130,-28,Pelicans,Warriors,0
Milwaukee Bucks,Miami Heat,122,114,8,Bucks,Heat,0
Denver Nuggets,Utah Jazz,110,102,8,Nuggets,Jazz,0
Los Angeles Lakers,Orlando Magic,106,103,3,Lakers,Magic,0
Cleveland Cavaliers,New York Knicks,91,109,-18,Cavaliers,Knicks,0
Phoenix Suns,San Antonio Spurs,114,115,-1,Suns,Spurs,0
LA Clippers,Orlando Magic,118,102,16,Clippers,Magic,0
Toronto Raptors,Milwaukee Bucks,130,111,19,Raptors,Bucks,0
Detroit Pistons,Portland Trail Blazers,101,110,-9,Pistons,Blazers,0
Oklahoma City Thunder,New Orleans Pelicans,106,110,-4,Thunder,Pelicans,0
Boston Celtics,Indiana Pacers,155,104,51,Celtics,Pacers,0
New York Knicks,Cleveland Cavaliers,89,95,-6,Knicks,Cavaliers,0
Miami Heat,Brooklyn Nets,105,109,-4,Heat,Nets,0
Atlanta Hawks,Washington Wizards,130,121,9,Hawks,Wizards,0
Minnesota Timberwolves,Denver Nuggets,110,89,21,Timberwolves,Nuggets,0
Houston Rockets,Charlotte Hornets,128,119,9,Rockets,Hornets,0
Dallas Mavericks,Chicago Bulls,114,105,9,Mavericks,Bulls,0
Utah Jazz,Memphis Grizzlies,133,109,24,Jazz,Grizzlies,0
Los Angeles Lakers,LA Clippers,130,125,5,Lakers,Clippers,0
Golden State Warriors,Sacramento Kings,102,101,1,Warriors,Kings,0
Philadelphia 76ers,Toronto Raptors,114,99,15,76ers,Raptors,0
New Orleans Pelicans,Detroit Pistons,125,116,9,Pelicans,Pistons,0
Utah Jazz,Orlando Magic,113,115,-2,Jazz,Magic,0
Phoenix Suns,San Antonio Spurs,121,132,-11,Suns,Spurs,0
Indiana Pacers,Cleveland Cavaliers,121,116,5,Pacers,Cavaliers,0
Milwaukee Bucks,New York Knicks,110,105,5,Bucks,Knicks,0
Oklahoma City Thunder,Golden State Warriors,139,141,-2,Thunder,Warriors,0
Miami Heat,Washington Wizards,121,114,7,Heat,Wizards,0
Chicago Bulls,Brooklyn Nets,107,109,-2,Bulls,Nets,0
Portland Trail Blazers,Memphis Grizzlies,115,113,2,Blazers,Grizzlies,0
Denver Nuggets,Dallas Mavericks,125,114,11,Nuggets,Mavericks,0
Philadelphia 76ers,Phoenix Suns,112,100,12,76ers,Suns,0
Indiana Pacers,Charlotte Hornets,124,125,-1,Pacers,Hornets,0
New Orleans Pelicans,Atlanta Hawks,105,123,-18,Pelicans,Hawks,0
Orlando Magic,Los Angeles Lakers,120,101,19,Magic,Lakers,0
Brooklyn Nets,Boston Celtics,114,124,-10,Nets,Celtics,0
Houston Rockets,Sacramento Kings,107,89,18,Rockets,Kings,0
Minnesota Timberwolves,Utah Jazz,123,95,28,Timberwolves,Jazz,0
Denver Nuggets,Chicago Bulls,123,101,22,Nuggets,Bulls,0
Detroit Pistons,Phoenix Suns,106,120,-14,Pistons,Suns,0
San Antonio Spurs,Toronto Raptors,116,123,-7,Spurs,Raptors,0
Cleveland Cavaliers,Golden State Warriors,115,104,11,Cavaliers,Warriors,0
Dallas Mavericks,Charlotte Hornets,124,118,6,Mavericks,Hornets,0
Portland Trail Blazers,Memphis Grizzlies,100,112,-12,Blazers,Grizzlies,0
Philadelphia 76ers,Washington Wizards,146,128,18,76ers,Wizards,0
Orlando Magic,Dallas Mavericks,102,117,-15,Magic,Mavericks,0
Indiana Pacers,San Antonio Spurs,152,111,41,Pacers,Spurs,0
Detroit Pistons,Golden State Warriors,109,120,-11,Pistons,Warriors,0
New York Knicks,LA Clippers,111,97,14,Knicks,Clippers,0
Miami Heat,Los Angeles Lakers,108,107,1,Heat,Lakers,0
Brooklyn Nets,Milwaukee Bucks,125,129,-4,Nets,Bucks,0
Houston Rockets,Sacramento Kings,122,97,25,Rockets,Kings,0
Minnesota Timberwolves,Boston Celtics,114,109,5,Timberwolves,Celtics,0
Oklahoma City Thunder,Atlanta Hawks,126,117,9,Thunder,Hawks,0
Chicago Bulls,Utah Jazz,130,113,17,Bulls,Jazz,0
Denver Nuggets,New Orleans Pelicans,134,116,18,Nuggets,Pelicans,0
Charlotte Hornets,Washington Wizards,116,132,-16,Hornets,Wizards,0
Philadelphia 76ers,Boston Celtics,106,103,3,76ers,Celtics,0
Indiana Pacers,Utah Jazz,134,118,16,Pacers,Jazz,0
New York Knicks,San Antonio Spurs,126,105,21,Knicks,Spurs,0
Brooklyn Nets,LA Clippers,100,93,7,Nets,Clippers,0
Minnesota Timberwolves,New Orleans Pelicans,122,101,21,Timberwolves,Pelicans,0
Houston Rockets,Los Angeles Lakers,128,94,34,Rockets,Lakers,0
Milwaukee Bucks,Detroit Pistons,120,118,2,Bucks,Pistons,0
Oklahoma City Thunder,Cleveland Cavaliers,128,120,8,Thunder,Cavaliers,0
Memphis Grizzlies,Miami Heat,102,108,-6,Grizzlies,Heat,0
Chicago Bulls,Phoenix Suns,115,116,-1,Bulls,Suns,0
Dallas Mavericks,Toronto Raptors,116,127,-11,Mavericks,Raptors,0
Denver Nuggets,Golden State Warriors,108,105,3,Nuggets,Warriors,0
Sacramento Kings,Portland Trail Blazers,121,118,3,Kings,Blazers,0
Indiana Pacers,Milwaukee Bucks,126,124,2,Pacers,Bucks,0
Orlando Magic,Atlanta Hawks,119,120,-1,Magic,Hawks,0
Washington Wizards,Charlotte Hornets,117,124,-7,Wizards,Hornets,0
Detroit Pistons,Philadelphia 76ers,106,114,-8,Pistons,76ers,0
Boston Celtics,Brooklyn Nets,121,107,14,Celtics,Nets,0
San Antonio Spurs,Minnesota Timberwolves,110,117,-7,Spurs,Timberwolves,0
Houston Rockets,New Orleans Pelicans,104,101,3,Rockets,Pelicans,0
Memphis Grizzlies,Utah Jazz,121,127,-6,Grizzlies,Jazz,0
Dallas Mavericks,LA Clippers,144,126,18,Mavericks,Clippers,0
Sacramento Kings,Oklahoma City Thunder,105,98,7,Kings,Thunder,0
Phoenix Suns,Los Angeles Lakers,119,122,-3,Suns,Lakers,0
Orlando Magic,Milwaukee Bucks,112,97,15,Magic,Bucks,0
Boston Celtics,Toronto Raptors,117,94,23,Celtics,Raptors,0
Atlanta Hawks,Miami Heat,109,117,-8,Hawks,Heat,0
Golden State Warriors,Cleveland Cavaliers,110,118,-8,Warriors,Cavaliers,0
New York Knicks,Charlotte Hornets,129,107,22,Knicks,Hornets,0
Brooklyn Nets,Washington Wizards,102,94,8,Nets,Wizards,0
LA Clippers,Memphis Grizzlies,101,105,-4,Clippers,Grizzlies,0
Philadelphia 76ers,Indiana Pacers,137,126,11,76ers,Pacers,0
Chicago Bulls,Detroit Pistons,119,108,11,Bulls,Pistons,0
New Orleans Pelicans,Dallas Mavericks,124,136,-12,Pelicans,Mavericks,0
Houston Rockets,Denver Nuggets,107,104,3,Rockets,Nuggets,0
San Antonio Spurs,Miami Heat,113,118,-5,Spurs,Heat,0
Phoenix Suns,Oklahoma City Thunder,99,111,-12,Suns,Thunder,0
Golden State Warriors,Minnesota Timberwolves,110,116,-6,Warriors,Timberwolves,0
Los Angeles Lakers,Portland Trail Blazers,116,110,6,Lakers,Blazers,0
Boston Celtics,New York Knicks,114,98,16,Celtics,Knicks,0
Toronto Raptors,Washington Wizards,111,107,4,Raptors,Wizards,0
Milwaukee Bucks,Chicago Bulls,118,109,9,Bucks,Bulls,0
Sacramento Kings,Cleveland Cavaliers,132,120,12,Kings,Cavaliers,0
Philadelphia 76ers,Indiana Pacers,126,132,-6,76ers,Pacers,0
Charlotte Hornets,Miami Heat,105,111,-6,Hornets,Heat,0
Detroit Pistons,Atlanta Hawks,120,126,-6,Pistons,Hawks,0
Oklahoma City Thunder,San Antonio Spurs,123,87,36,Thunder,Spurs,0
Brooklyn Nets,Orlando Magic,124,104,20,Nets,Magic,0
New Orleans Pelicans,Dallas Mavericks,131,110,21,Pelicans,Mavericks,0
Utah Jazz,Portland Trail Blazers,115,99,16,Jazz,Blazers,0
Denver Nuggets,LA Clippers,111,108,3,Nuggets,Clippers,0
Golden State Warriors,Minnesota Timberwolves,101,104,-3,Warriors,Timberwolves,0
Los Angeles Lakers,Memphis Grizzlies,134,107,27,Lakers,Grizzlies,0
Washington Wizards,Dallas Mavericks,117,130,-13,Wizards,Mavericks,0
Toronto Raptors,Milwaukee Bucks,112,128,-16,Raptors,Bucks,0
Philadelphia 76ers,Boston Celtics,107,117,-10,76ers,Celtics,0
Atlanta Hawks,New York Knicks,114,116,-2,Hawks,Knicks,0
Chicago Bulls,Orlando Magic,94,96,-2,Bulls,Magic,0
Phoenix Suns,Minnesota Timberwolves,133,115,18,Suns,Timberwolves,0
Los Angeles Lakers,Sacramento Kings,110,125,-15,Lakers,Kings,0
Portland Trail Blazers,Cleveland Cavaliers,95,109,-14,Blazers,Cavaliers,0
Miami Heat,Brooklyn Nets,122,115,7,Heat,Nets,0
Golden State Warriors,Oklahoma City Thunder,109,128,-19,Warriors,Thunder,0
Washington Wizards,New York Knicks,99,120,-21,Wizards,Knicks,0
Charlotte Hornets,Milwaukee Bucks,99,130,-31,Hornets,Bucks,0
Toronto Raptors,Boston Celtics,105,108,-3,Raptors,Celtics,0
Atlanta Hawks,Philadelphia 76ers,116,126,-10,Hawks,76ers,0
San Antonio Spurs,Sacramento Kings,120,129,-9,Spurs,Kings,0
Cleveland Cavaliers,Detroit Pistons,108,100,8,Cavaliers,Pistons,0
New Orleans Pelicans,Denver Nuggets,115,110,5,Pelicans,Nuggets,0
Chicago Bulls,Orlando Magic,97,103,-6,Bulls,Magic,0
Portland Trail Blazers,Los Angeles Lakers,95,107,-12,Blazers,Lakers,0
Utah Jazz,Phoenix Suns,128,131,-3,Jazz,Suns,0
LA Clippers,Houston Rockets,106,100,6,Clippers,Rockets,0
Charlotte Hornets,New York Knicks,108,122,-14,Hornets,Knicks,0
New Orleans Pelicans,Minnesota Timberwolves,120,121,-1,Pelicans,Timberwolves,0
Chicago Bulls,Miami Heat,102,97,5,Bulls,Heat,0
Milwaukee Bucks,Dallas Mavericks,132,125,7,Bucks,Mavericks,0
San Antonio Spurs,Memphis Grizzlies,108,120,-12,Spurs,Grizzlies,0
Golden State Warriors,Oklahoma City Thunder,123,130,-7,Warriors,Thunder,0
Brooklyn Nets,Philadelphia 76ers,99,121,-22,Nets,76ers,0
Toronto Raptors,Detroit Pistons,142,113,29,Raptors,Pistons,0
Indiana Pacers,Orlando Magic,116,128,-12,Pacers,Magic,0
Cleveland Cavaliers,Denver Nuggets,121,109,12,Cavaliers,Nuggets,0
Dallas Mavericks,Sacramento Kings,113,129,-16,Mavericks,Kings,0
Utah Jazz,Phoenix Suns,137,140,-3,Jazz,Suns,0
Memphis Grizzlies,Boston Celtics,100,102,-2,Grizzlies,Celtics,0
Portland Trail Blazers,Oklahoma City Thunder,91,134,-43,Blazers,Thunder,0
Los Angeles Lakers,Houston Rockets,105,104,1,Lakers,Rockets,0
Detroit Pistons,Denver Nuggets,103,107,-4,Pistons,Nuggets,0
Charlotte Hornets,Boston Celtics,121,118,3,Hornets,Celtics,0
Washington Wizards,Milwaukee Bucks,129,142,-13,Wizards,Bucks,0
Minnesota Timberwolves,New York Knicks,117,100,17,Timberwolves,Knicks,0
San Antonio Spurs,LA Clippers,99,124,-25,Spurs,Clippers,0
New Orleans Pelicans,Sacramento Kings,129,93,36,Pelicans,Kings,0
Chicago Bulls,Miami Heat,100,118,-18,Bulls,Heat,0
Golden State Warriors,Houston Rockets,121,116,5,Warriors,Rockets,0
Orlando Magic,Toronto Raptors,126,107,19,Magic,Raptors,0
Philadelphia 76ers,Cleveland Cavaliers,119,122,-3,76ers,Cavaliers,0
Atlanta Hawks,Indiana Pacers,152,157,-5,Hawks,Pacers,0
Phoenix Suns,Portland Trail Blazers,120,107,13,Suns,Blazers,0
Los Angeles Lakers,Utah Jazz,131,99,32,Lakers,Jazz,0
Charlotte Hornets,Washington Wizards,117,114,3,Hornets,Wizards,0
Orlando Magic,Denver Nuggets,124,119,5,Magic,Nuggets,0
Boston Celtics,Milwaukee Bucks,119,116,3,Celtics,Bucks,0
Cleveland Cavaliers,Miami Heat,96,129,-33,Cavaliers,Heat,0
Indiana Pacers,Toronto Raptors,131,132,-1,Pacers,Raptors,0
Atlanta Hawks,Brooklyn Nets,147,145,2,Hawks,Nets,0
Houston Rockets,Memphis Grizzlies,111,91,20,Rockets,Grizzlies,0
Minnesota Timberwolves,Philadelphia 76ers,112,99,13,Timberwolves,76ers,0
New Orleans Pelicans,Sacramento Kings,117,112,5,Pelicans,Kings,0
San Antonio Spurs,LA Clippers,102,109,-7,Spurs,Clippers,0
Oklahoma City Thunder,Chicago Bulls,116,102,14,Thunder,Bulls,0
Portland Trail Blazers,Utah Jazz,121,105,16,Blazers,Jazz,0
Phoenix Suns,Golden State Warriors,123,115,8,Suns,Warriors,0
Los Angeles Lakers,Dallas Mavericks,101,104,-3,Lakers,Mavericks,0
Orlando Magic,Boston Celtics,113,96,17,Magic,Celtics,0
Memphis Grizzlies,Phoenix Suns,89,110,-21,Grizzlies,Suns,0
New York Knicks,Miami Heat,100,98,2,Knicks,Heat,0
Toronto Raptors,Chicago Bulls,121,108,13,Raptors,Bulls,0
Indiana Pacers,Detroit Pistons,136,113,23,Pacers,Pistons,0
Minnesota Timberwolves,Sacramento Kings,111,124,-13,Timberwolves,Kings,0
Milwaukee Bucks,Washington Wizards,131,128,3,Bucks,Wizards,0
Houston Rockets,Denver Nuggets,105,86,19,Rockets,Nuggets,0
Golden State Warriors,San Antonio Spurs,118,112,6,Warriors,Spurs,0
LA Clippers,New Orleans Pelicans,106,116,-10,Clippers,Pelicans,0
Oklahoma City Thunder,Philadelphia 76ers,123,127,-4,Thunder,76ers,0
Brooklyn Nets,Miami Heat,112,97,15,Nets,Heat,0
Washington Wizards,Atlanta Hawks,108,136,-28,Wizards,Hawks,0
Cleveland Cavaliers,Los Angeles Lakers,115,121,-6,Cavaliers,Lakers,0
Utah Jazz,New Orleans Pelicans,105,100,5,Jazz,Pelicans,0
LA Clippers,Dallas Mavericks,107,88,19,Clippers,Mavericks,0
Milwaukee Bucks,Portland Trail Blazers,108,102,6,Bucks,Blazers,0
Memphis Grizzlies,Minnesota Timberwolves,97,119,-22,Grizzlies,Timberwolves,0
Orlando Magic,Charlotte Hornets,130,117,13,Magic,Hornets,0
New York Knicks,Phoenix Suns,113,116,-3,Knicks,Suns,0
Boston Celtics,Atlanta Hawks,113,103,10,Celtics,Hawks,0
Cleveland Cavaliers,Toronto Raptors,105,102,3,Cavaliers,Raptors,0
Brooklyn Nets,Chicago Bulls,118,109,9,Nets,Bulls,0
Denver Nuggets,San Antonio Spurs,132,120,12,Nuggets,Spurs,0
Detroit Pistons,Washington Wizards,107,126,-19,Pistons,Wizards,0
Philadelphia 76ers,Los Angeles Lakers,138,94,44,76ers,Lakers,0
Indiana Pacers,Portland Trail Blazers,110,114,-4,Pacers,Blazers,0
Utah Jazz,New Orleans Pelicans,114,112,2,Jazz,Pelicans,0
LA Clippers,Denver Nuggets,104,113,-9,Clippers,Nuggets,0
Brooklyn Nets,Toronto Raptors,115,103,12,Nets,Raptors,0
New York Knicks,Charlotte Hornets,115,91,24,Knicks,Hornets,0
Cleveland Cavaliers,Atlanta Hawks,128,105,23,Cavaliers,Hawks,0
Boston Celtics,Chicago Bulls,124,97,27,Celtics,Bulls,0
Miami Heat,Milwaukee Bucks,124,131,-7,Heat,Bucks,0
Minnesota Timberwolves,Oklahoma City Thunder,106,103,3,Timberwolves,Thunder,0
Dallas Mavericks,Houston Rockets,121,115,6,Mavericks,Rockets,0
Sacramento Kings,Golden State Warriors,124,123,1,Kings,Warriors,0
Detroit Pistons,Los Angeles Lakers,107,133,-26,Pistons,Lakers,0
Orlando Magic,Washington Wizards,139,120,19,Magic,Wizards,0
Toronto Raptors,Phoenix Suns,112,105,7,Raptors,Suns,0
Memphis Grizzlies,Utah Jazz,105,91,14,Grizzlies,Jazz,0
New Orleans Pelicans,Philadelphia 76ers,124,114,10,Pelicans,76ers,0
Denver Nuggets,Houston Rockets,134,124,10,Nuggets,Rockets,0
Sacramento Kings,LA Clippers,117,131,-14,Kings,Clippers,0
Cleveland Cavaliers,Portland Trail Blazers,95,103,-8,Cavaliers,Blazers,0
Brooklyn Nets,Charlotte Hornets,128,129,-1,Nets,Hornets,0
New York Knicks,Detroit Pistons,118,112,6,Knicks,Pistons,0
Miami Heat,Indiana Pacers,142,132,10,Heat,Pacers,0
Oklahoma City Thunder,Los Angeles Lakers,133,110,23,Thunder,Lakers,0
San Antonio Spurs,Atlanta Hawks,135,137,-2,Spurs,Hawks,0
Chicago Bulls,Milwaukee Bucks,120,113,7,Bulls,Bucks,0
Minnesota Timberwolves,Utah Jazz,101,90,11,Timberwolves,Jazz,0
Golden State Warriors,LA Clippers,120,114,6,Warriors,Clippers,0
Orlando Magic,Washington Wizards,130,125,5,Magic,Wizards,0
Toronto Raptors,New York Knicks,106,119,-13,Raptors,Knicks,0
Dallas Mavericks,Memphis Grizzlies,94,108,-14,Mavericks,Grizzlies,0
Boston Celtics,Philadelphia 76ers,125,119,6,Celtics,76ers,0
New Orleans Pelicans,San Antonio Spurs,121,106,15,Pelicans,Spurs,0
Phoenix Suns,Denver Nuggets,111,119,-8,Suns,Nuggets,0
LA Clippers,Golden State Warriors,113,112,1,Clippers,Warriors,0
Charlotte Hornets,Minnesota Timberwolves,117,123,-6,Hornets,Timberwolves,0
Brooklyn Nets,Orlando Magic,129,101,28,Nets,Magic,0
Detroit Pistons,Cleveland Cavaliers,101,110,-9,Pistons,Cavaliers,0
Chicago Bulls,New Orleans Pelicans,124,118,6,Bulls,Pelicans,0
Miami Heat,Indiana Pacers,129,144,-15,Heat,Pacers,0
Milwaukee Bucks,Atlanta Hawks,132,121,11,Bucks,Hawks,0
Phoenix Suns,Memphis Grizzlies,116,109,7,Suns,Grizzlies,0
Dallas Mavericks,Oklahoma City Thunder,120,126,-6,Mavericks,Thunder,0
Utah Jazz,Portland Trail Blazers,118,113,5,Jazz,Blazers,0
Sacramento Kings,Denver Nuggets,123,117,6,Kings,Nuggets,0
Los Angeles Lakers,Houston Rockets,107,97,10,Lakers,Rockets,0
Indiana Pacers,Boston Celtics,122,112,10,Pacers,Celtics,0
Sacramento Kings,New Orleans Pelicans,117,127,-10,Kings,Pelicans,0
Milwaukee Bucks,New York Knicks,146,122,24,Bucks,Knicks,0
Los Angeles Lakers,Phoenix Suns,106,103,3,Lakers,Suns,0
Washington Wizards,Philadelphia 76ers,126,131,-5,Wizards,76ers,0
Detroit Pistons,Memphis Grizzlies,102,116,-14,Pistons,Grizzlies,0
Cleveland Cavaliers,Orlando Magic,121,111,10,Cavaliers,Magic,0
Atlanta Hawks,Brooklyn Nets,113,114,-1,Hawks,Nets,0
Minnesota Timberwolves,San Antonio Spurs,102,94,8,Timberwolves,Spurs,0
Toronto Raptors,Miami Heat,103,112,-9,Raptors,Heat,0
Chicago Bulls,Charlotte Hornets,111,100,11,Bulls,Hornets,0
Houston Rockets,Oklahoma City Thunder,110,101,9,Rockets,Thunder,0
Dallas Mavericks,Utah Jazz,147,97,50,Mavericks,Jazz,0
LA Clippers,Denver Nuggets,111,102,9,Clippers,Nuggets,0
Golden State Warriors,Portland Trail Blazers,110,106,4,Warriors,Blazers,0
Milwaukee Bucks,Indiana Pacers,119,128,-9,Bucks,Pacers,0
Los Angeles Lakers,New Orleans Pelicans,133,89,44,Lakers,Pelicans,0
Charlotte Hornets,Toronto Raptors,119,116,3,Hornets,Raptors,0
Orlando Magic,Detroit Pistons,123,91,32,Magic,Pistons,0
Philadelphia 76ers,Atlanta Hawks,125,114,11,76ers,Hawks,0
Brooklyn Nets,Washington Wizards,124,97,27,Nets,Wizards,0
Boston Celtics,New York Knicks,133,123,10,Celtics,Knicks,0
Memphis Grizzlies,Minnesota Timberwolves,103,127,-24,Grizzlies,Timberwolves,0
Miami Heat,Cleveland Cavaliers,99,111,-12,Heat,Cavaliers,0
Oklahoma City Thunder,Golden State Warriors,138,136,2,Thunder,Warriors,0
San Antonio Spurs,Chicago Bulls,112,121,-9,Spurs,Bulls,0
Phoenix Suns,Sacramento Kings,106,114,-8,Suns,Kings,0
Denver Nuggets,Houston Rockets,106,114,-8,Nuggets,Rockets,0
Utah Jazz,LA Clippers,103,117,-14,Jazz,Clippers,0
Portland Trail Blazers,Dallas Mavericks,112,125,-13,Blazers,Mavericks,0
Los Angeles Lakers,Indiana Pacers,123,109,14,Lakers,Pacers,0
Detroit Pistons,Indiana Pacers,123,131,-8,Pistons,Pacers,0
Philadelphia 76ers,Washington Wizards,146,101,45,76ers,Wizards,0
Charlotte Hornets,Miami Heat,114,116,-2,Hornets,Heat,0
Orlando Magic,Cleveland Cavaliers,104,94,10,Magic,Cavaliers,0
New York Knicks,Toronto Raptors,136,130,6,Knicks,Raptors,0
Atlanta Hawks,Denver Nuggets,122,129,-7,Hawks,Nuggets,0
Milwaukee Bucks,Chicago Bulls,133,129,4,Bucks,Bulls,0
New Orleans Pelicans,Minnesota Timberwolves,121,107,14,Pelicans,Timberwolves,0
Houston Rockets,San Antonio Spurs,93,82,11,Rockets,Spurs,0
Memphis Grizzlies,Dallas Mavericks,113,120,-7,Grizzlies,Mavericks,0
Oklahoma City Thunder,Utah Jazz,134,120,14,Thunder,Jazz,0
Sacramento Kings,Brooklyn Nets,131,118,13,Kings,Nets,0
LA Clippers,Portland Trail Blazers,132,127,5,Clippers,Blazers,0
Dallas Mavericks,Los Angeles Lakers,127,125,2,Mavericks,Lakers,0
Boston Celtics,Cleveland Cavaliers,120,113,7,Celtics,Cavaliers,0
Chicago Bulls,Denver Nuggets,106,114,-8,Bulls,Nuggets,0
Phoenix Suns,Golden State Warriors,119,116,3,Suns,Warriors,0
LA Clippers,Sacramento Kings,119,99,20,Clippers,Kings,0
Detroit Pistons,Philadelphia 76ers,111,129,-18,Pistons,76ers,0
Washington Wizards,New Orleans Pelicans,122,142,-20,Wizards,Pelicans,0
Miami Heat,Charlotte Hornets,115,104,11,Heat,Hornets,0
Toronto Raptors,Atlanta Hawks,135,128,7,Raptors,Hawks,0
San Antonio Spurs,Los Angeles Lakers,119,122,-3,Spurs,Lakers,0
Milwaukee Bucks,Indiana Pacers,140,126,14,Bucks,Pacers,0
Houston Rockets,Memphis Grizzlies,117,104,13,Rockets,Grizzlies,0
Utah Jazz,New York Knicks,117,113,4,Jazz,Knicks,0
Phoenix Suns,Brooklyn Nets,112,116,-4,Suns,Nets,0
Boston Celtics,Cleveland Cavaliers,116,107,9,Celtics,Cavaliers,0
Miami Heat,Chicago Bulls,116,124,-8,Heat,Bulls,0
Dallas Mavericks,Minnesota Timberwolves,101,119,-18,Mavericks,Timberwolves,0
Denver Nuggets,Brooklyn Nets,124,101,23,Nuggets,Nets,0
Portland Trail Blazers,Utah Jazz,114,122,-8,Blazers,Jazz,0
Sacramento Kings,Oklahoma City Thunder,128,123,5,Kings,Thunder,0
LA Clippers,Golden State Warriors,121,113,8,Clippers,Warriors,0
Philadelphia 76ers,Detroit Pistons,124,92,32,76ers,Pistons,0
Washington Wizards,Indiana Pacers,137,123,14,Wizards,Pacers,0
Charlotte Hornets,New Orleans Pelicans,107,112,-5,Hornets,Pelicans,0
Boston Celtics,Orlando Magic,128,111,17,Celtics,Magic,0
San Antonio Spurs,Los Angeles Lakers,129,115,14,Spurs,Lakers,0
Toronto Raptors,Atlanta Hawks,104,125,-21,Raptors,Hawks,0
Memphis Grizzlies,Houston Rockets,96,103,-7,Grizzlies,Rockets,0
Phoenix Suns,New York Knicks,122,139,-17,Suns,Knicks,0
Milwaukee Bucks,Detroit Pistons,146,114,32,Bucks,Pistons,0
Charlotte Hornets,Philadelphia 76ers,82,135,-53,Hornets,76ers,0
Cleveland Cavaliers,Atlanta Hawks,127,119,8,Cavaliers,Hawks,0
Minnesota Timberwolves,Indiana Pacers,127,109,18,Timberwolves,Pacers,0
Miami Heat,Chicago Bulls,118,116,2,Heat,Bulls,0
Golden State Warriors,Brooklyn Nets,124,120,4,Warriors,Nets,0
Denver Nuggets,Oklahoma City Thunder,117,118,-1,Nuggets,Thunder,0
Portland Trail Blazers,Dallas Mavericks,120,131,-11,Blazers,Mavericks,0
Sacramento Kings,Utah Jazz,125,104,21,Kings,Jazz,0
LA Clippers,New York Knicks,144,122,22,Clippers,Knicks,0
Boston Celtics,Orlando Magic,114,97,17,Celtics,Magic,0
San Antonio Spurs,New Orleans Pelicans,110,146,-36,Spurs,Pelicans,0
Milwaukee Bucks,Houston Rockets,128,119,9,Bucks,Rockets,0
Phoenix Suns,Washington Wizards,112,108,4,Suns,Wizards,0
Portland Trail Blazers,Golden State Warriors,114,118,-4,Blazers,Warriors,0
Indiana Pacers,LA Clippers,127,151,-24,Pacers,Clippers,0
Cleveland Cavaliers,Houston Rockets,135,130,5,Cavaliers,Rockets,0
Philadelphia 76ers,Chicago Bulls,104,108,-4,76ers,Bulls,0
Miami Heat,Minnesota Timberwolves,108,112,-4,Heat,Timberwolves,0
Toronto Raptors,Charlotte Hornets,114,99,15,Raptors,Hornets,0
Atlanta Hawks,Detroit Pistons,130,124,6,Hawks,Pistons,0
Oklahoma City Thunder,Memphis Grizzlies,116,97,19,Thunder,Grizzlies,0
Denver Nuggets,Dallas Mavericks,130,104,26,Nuggets,Mavericks,0
Utah Jazz,Brooklyn Nets,125,108,17,Jazz,Nets,0
Sacramento Kings,Washington Wizards,143,131,12,Kings,Wizards,0
Los Angeles Lakers,New York Knicks,109,114,-5,Lakers,Knicks,0
New Orleans Pelicans,Memphis Grizzlies,113,115,-2,Pelicans,Grizzlies,0
Milwaukee Bucks,San Antonio Spurs,132,119,13,Bucks,Spurs,0
Portland Trail Blazers,Phoenix Suns,109,104,5,Blazers,Suns,0
Golden State Warriors,Boston Celtics,132,126,6,Warriors,Celtics,0
Indiana Pacers,Charlotte Hornets,144,113,31,Pacers,Hornets,0
Orlando Magic,Miami Heat,106,115,-9,Magic,Heat,0
Philadelphia 76ers,Minnesota Timberwolves,127,113,14,76ers,Timberwolves,0
Cleveland Cavaliers,Utah Jazz,124,116,8,Cavaliers,Jazz,0
Brooklyn Nets,New York Knicks,102,121,-19,Nets,Knicks,0
Toronto Raptors,Denver Nuggets,104,113,-9,Raptors,Nuggets,0
Houston Rockets,Atlanta Hawks,127,134,-7,Rockets,Hawks,0
Chicago Bulls,Los Angeles Lakers,124,108,16,Bulls,Lakers,0
Dallas Mavericks,LA Clippers,111,120,-9,Mavericks,Clippers,0
Sacramento Kings,Boston Celtics,119,144,-25,Kings,Celtics,0
Detroit Pistons,Utah Jazz,111,119,-8,Pistons,Jazz,0
Cleveland Cavaliers,New Orleans Pelicans,104,123,-19,Cavaliers,Pelicans,0
Milwaukee Bucks,Orlando Magic,118,114,4,Bucks,Magic,0
Chicago Bulls,San Antonio Spurs,114,95,19,Bulls,Spurs,0
Memphis Grizzlies,Indiana Pacers,116,103,13,Grizzlies,Pacers,0
Oklahoma City Thunder,LA Clippers,134,115,19,Thunder,Clippers,0
Minnesota Timberwolves,Los Angeles Lakers,118,111,7,Timberwolves,Lakers,0
Portland Trail Blazers,Washington Wizards,117,118,-1,Blazers,Wizards,0
Philadelphia 76ers,Toronto Raptors,121,111,10,76ers,Raptors,0
Brooklyn Nets,Denver Nuggets,117,122,-5,Nets,Nuggets,0
Miami Heat,Atlanta Hawks,122,113,9,Heat,Hawks,0
Houston Rockets,Dallas Mavericks,122,96,26,Rockets,Mavericks,0
Sacramento Kings,Phoenix Suns,120,105,15,Kings,Suns,0
Golden State Warriors,Washington Wizards,129,118,11,Warriors,Wizards,0
New York Knicks,Milwaukee Bucks,111,130,-19,Knicks,Bucks,0
LA Clippers,Boston Celtics,108,145,-37,Clippers,Celtics,0
New Orleans Pelicans,Houston Rockets,104,106,-2,Pelicans,Rockets,0
Charlotte Hornets,Denver Nuggets,95,102,-7,Hornets,Nuggets,0
Indiana Pacers,Orlando Magic,110,117,-7,Pacers,Magic,0
Toronto Raptors,Utah Jazz,119,126,-7,Raptors,Jazz,0
Brooklyn Nets,Detroit Pistons,126,115,11,Nets,Pistons,0
Atlanta Hawks,Memphis Grizzlies,119,125,-6,Hawks,Grizzlies,0
Chicago Bulls,Cleveland Cavaliers,95,109,-14,Bulls,Cavaliers,0
Oklahoma City Thunder,Los Angeles Lakers,120,129,-9,Thunder,Lakers,0
Golden State Warriors,Portland Trail Blazers,126,106,20,Warriors,Blazers,0
Dallas Mavericks,San Antonio Spurs,144,119,25,Mavericks,Spurs,0
Sacramento Kings,Minnesota Timberwolves,98,110,-12,Kings,Timberwolves,0
New York Knicks,Milwaukee Bucks,129,122,7,Knicks,Bucks,0
Denver Nuggets,Golden State Warriors,120,114,6,Nuggets,Warriors,0
Los Angeles Lakers,Boston Celtics,115,126,-11,Lakers,Celtics,0
Miami Heat,Philadelphia 76ers,119,113,6,Heat,76ers,0
Phoenix Suns,Dallas Mavericks,114,128,-14,Suns,Mavericks,0
Washington Wizards,Orlando Magic,119,127,-8,Wizards,Magic,0
Detroit Pistons,Brooklyn Nets,112,118,-6,Pistons,Nets,0
San Antonio Spurs,Utah Jazz,118,130,-12,Spurs,Jazz,0
Chicago Bulls,Atlanta Hawks,118,113,5,Bulls,Hawks,0
Houston Rockets,Indiana Pacers,117,123,-6,Rockets,Pacers,0
New Orleans Pelicans,Memphis Grizzlies,115,116,-1,Pelicans,Grizzlies,0
Oklahoma City Thunder,Minnesota Timberwolves,129,106,23,Thunder,Timberwolves,0
Portland Trail Blazers,Sacramento Kings,130,113,17,Blazers,Kings,0
LA Clippers,Charlotte Hornets,113,104,9,Clippers,Hornets,0
Washington Wizards,Toronto Raptors,102,132,-30,Wizards,Raptors,0
Orlando Magic,Philadelphia 76ers,92,112,-20,Magic,76ers,0
Brooklyn Nets,Milwaukee Bucks,122,144,-22,Nets,Bucks,0
Houston Rockets,Phoenix Suns,113,129,-16,Rockets,Suns,0
Oklahoma City Thunder,New York Knicks,129,120,9,Thunder,Knicks,0
Dallas Mavericks,Cleveland Cavaliers,110,113,-3,Mavericks,Cavaliers,0
Boston Celtics,Detroit Pistons,128,122,6,Celtics,Pistons,0
New Orleans Pelicans,Utah Jazz,112,105,7,Pelicans,Jazz,0
Minnesota Timberwolves,Dallas Mavericks,118,110,8,Timberwolves,Mavericks,0
Chicago Bulls,Indiana Pacers,104,120,-16,Bulls,Pacers,0
Denver Nuggets,Memphis Grizzlies,142,105,37,Nuggets,Grizzlies,0
Golden State Warriors,Miami Heat,102,114,-12,Warriors,Heat,0
Portland Trail Blazers,San Antonio Spurs,105,118,-13,Blazers,Spurs,0
Los Angeles Lakers,Charlotte Hornets,133,112,21,Lakers,Hornets,0
Orlando Magic,New York Knicks,117,108,9,Magic,Knicks,0
Washington Wizards,Brooklyn Nets,110,104,6,Wizards,Nets,0
Cleveland Cavaliers,Milwaukee Bucks,111,119,-8,Cavaliers,Bucks,0
Atlanta Hawks,Sacramento Kings,110,117,-7,Hawks,Kings,0
Boston Celtics,Toronto Raptors,120,118,2,Celtics,Raptors,0
Houston Rockets,Philadelphia 76ers,127,131,-4,Rockets,76ers,0
Denver Nuggets,Oklahoma City Thunder,93,119,-26,Nuggets,Thunder,0
Phoenix Suns,Charlotte Hornets,133,119,14,Suns,Hornets,0
Portland Trail Blazers,San Antonio Spurs,134,128,6,Blazers,Spurs,0
LA Clippers,Memphis Grizzlies,117,106,11,Clippers,Grizzlies,0
Utah Jazz,Miami Heat,117,109,8,Jazz,Heat,0
Detroit Pistons,Toronto Raptors,129,127,2,Pistons,Raptors,0
Indiana Pacers,New York Knicks,140,126,14,Pacers,Knicks,0
Minnesota Timberwolves,Los Angeles Lakers,108,106,2,Timberwolves,Lakers,0
Chicago Bulls,Philadelphia 76ers,105,92,13,Bulls,76ers,0
Golden State Warriors,Dallas Mavericks,122,132,-10,Warriors,Mavericks,0
Washington Wizards,Atlanta Hawks,126,130,-4,Wizards,Hawks,0
San Antonio Spurs,Boston Celtics,101,134,-33,Spurs,Celtics,0
New Orleans Pelicans,Los Angeles Lakers,129,109,20,Pelicans,Lakers,0
Oklahoma City Thunder,Brooklyn Nets,124,108,16,Thunder,Nets,0
Memphis Grizzlies,Sacramento Kings,92,123,-31,Grizzlies,Kings,0
Phoenix Suns,Orlando Magic,112,107,5,Suns,Magic,0
New York Knicks,Minnesota Timberwolves,112,106,6,Knicks,Timberwolves,0
Toronto Raptors,Cleveland Cavaliers,124,121,3,Raptors,Cavaliers,0
Milwaukee Bucks,Indiana Pacers,113,122,-9,Bucks,Pacers,0
Houston Rockets,Detroit Pistons,136,113,23,Rockets,Pistons,0
Denver Nuggets,Charlotte Hornets,111,93,18,Nuggets,Hornets,0
Phoenix Suns,Portland Trail Blazers,109,88,21,Suns,Blazers,0
Utah Jazz,Dallas Mavericks,127,90,37,Jazz,Mavericks,0
LA Clippers,Miami Heat,121,104,17,Clippers,Heat,0
Philadelphia 76ers,Chicago Bulls,110,97,13,76ers,Bulls,0
New Orleans Pelicans,Brooklyn Nets,112,85,27,Pelicans,Nets,0
Memphis Grizzlies,San Antonio Spurs,106,98,8,Grizzlies,Spurs,0
Oklahoma City Thunder,Boston Celtics,127,123,4,Thunder,Celtics,0
Golden State Warriors,Orlando Magic,121,115,6,Warriors,Magic,0
Sacramento Kings,Charlotte Hornets,104,111,-7,Kings,Hornets,0
Cleveland Cavaliers,Washington Wizards,140,101,39,Cavaliers,Wizards,0
Indiana Pacers,Milwaukee Bucks,142,130,12,Pacers,Bucks,0
Atlanta Hawks,Oklahoma City Thunder,141,138,3,Hawks,Thunder,0
Houston Rockets,Brooklyn Nets,112,101,11,Rockets,Nets,0
Minnesota Timberwolves,New Orleans Pelicans,106,117,-11,Timberwolves,Pelicans,0
Memphis Grizzlies,Toronto Raptors,111,116,-5,Grizzlies,Raptors,0
New York Knicks,Chicago Bulls,116,100,16,Knicks,Bulls,0
Dallas Mavericks,Portland Trail Blazers,126,97,29,Mavericks,Blazers,0
Phoenix Suns,LA Clippers,122,131,-9,Suns,Clippers,0
Utah Jazz,Detroit Pistons,154,148,6,Jazz,Pistons,0
Los Angeles Lakers,Miami Heat,96,110,-14,Lakers,Heat,0
Sacramento Kings,Orlando Magic,138,135,3,Kings,Magic,0
San Antonio Spurs,Milwaukee Bucks,121,125,-4,Spurs,Bucks,0
Golden State Warriors,Denver Nuggets,127,130,-3,Warriors,Nuggets,0
Boston Celtics,Utah Jazz,126,97,29,Celtics,Jazz,0
Indiana Pacers,Atlanta Hawks,150,116,34,Pacers,Hawks,0
Cleveland Cavaliers,Washington Wizards,114,90,24,Cavaliers,Wizards,0
Philadelphia 76ers,New York Knicks,92,128,-36,76ers,Knicks,0
Brooklyn Nets,Oklahoma City Thunder,124,115,9,Nets,Thunder,0
Houston Rockets,Minnesota Timberwolves,95,122,-27,Rockets,Timberwolves,0
Chicago Bulls,Charlotte Hornets,104,91,13,Bulls,Hornets,0
New Orleans Pelicans,LA Clippers,95,111,-16,Pelicans,Clippers,0
Dallas Mavericks,Portland Trail Blazers,139,103,36,Mavericks,Blazers,0
Denver Nuggets,Orlando Magic,120,122,-2,Nuggets,Magic,0
Phoenix Suns,Miami Heat,113,97,16,Suns,Heat,0
Sacramento Kings,Toronto Raptors,135,130,5,Kings,Raptors,0
Los Angeles Lakers,Memphis Grizzlies,113,127,-14,Lakers,Grizzlies,0
Golden State Warriors,Detroit Pistons,113,109,4,Warriors,Pistons,0
Indiana Pacers,Boston Celtics,101,118,-17,Pacers,Celtics,0
Washington Wizards,New York Knicks,105,121,-16,Wizards,Knicks,0
Philadelphia 76ers,Utah Jazz,109,120,-11,76ers,Jazz,0
Houston Rockets,Milwaukee Bucks,112,108,4,Rockets,Bucks,0
Cleveland Cavaliers,San Antonio Spurs,117,115,2,Cavaliers,Spurs,0
Brooklyn Nets,Portland Trail Blazers,127,134,-7,Nets,Blazers,0
Sacramento Kings,New Orleans Pelicans,100,133,-33,Kings,Pelicans,0
Orlando Magic,Atlanta Hawks,117,110,7,Magic,Hawks,0
Dallas Mavericks,Minnesota Timberwolves,115,108,7,Mavericks,Timberwolves,0
Phoenix Suns,Memphis Grizzlies,115,121,-6,Suns,Grizzlies,0
Denver Nuggets,Detroit Pistons,131,114,17,Nuggets,Pistons,0
Golden State Warriors,Toronto Raptors,118,133,-15,Warriors,Raptors,0
Los Angeles Lakers,LA Clippers,106,103,3,Lakers,Clippers,0
Indiana Pacers,Boston Celtics,133,131,2,Pacers,Celtics,0
Washington Wizards,Oklahoma City Thunder,128,136,-8,Wizards,Thunder,0
Charlotte Hornets,Chicago Bulls,112,119,-7,Hornets,Bulls,0
Miami Heat,Houston Rockets,120,113,7,Heat,Rockets,0
Milwaukee Bucks,Utah Jazz,116,132,-16,Bucks,Jazz,0
LA Clippers,Phoenix Suns,138,111,27,Clippers,Suns,0
Orlando Magic,Minnesota Timberwolves,92,113,-21,Magic,Timberwolves,0
Detroit Pistons,Sacramento Kings,110,131,-21,Pistons,Kings,0
New York Knicks,Portland Trail Blazers,112,84,28,Knicks,Blazers,0
Dallas Mavericks,Memphis Grizzlies,103,120,-17,Mavericks,Grizzlies,0
Los Angeles Lakers,Toronto Raptors,132,131,1,Lakers,Raptors,0
Charlotte Hornets,Sacramento Kings,98,123,-25,Hornets,Kings,0
Indiana Pacers,Washington Wizards,112,104,8,Pacers,Wizards,0
Boston Celtics,Minnesota Timberwolves,127,120,7,Celtics,Timberwolves,0
Detroit Pistons,San Antonio Spurs,108,130,-22,Pistons,Spurs,0
Miami Heat,Oklahoma City Thunder,120,128,-8,Heat,Thunder,0
Atlanta Hawks,Philadelphia 76ers,139,132,7,Hawks,76ers,0
Chicago Bulls,Houston Rockets,124,119,5,Bulls,Rockets,0
Golden State Warriors,New Orleans Pelicans,105,141,-36,Warriors,Pelicans,0
Utah Jazz,Denver Nuggets,124,111,13,Jazz,Nuggets,0
LA Clippers,Toronto Raptors,126,120,6,Clippers,Raptors,0
Cleveland Cavaliers,Brooklyn Nets,111,102,9,Cavaliers,Nets,0
Milwaukee Bucks,Boston Celtics,135,102,33,Bucks,Celtics,0
Oklahoma City Thunder,Portland Trail Blazers,139,77,62,Thunder,Blazers,0
Dallas Mavericks,New York Knicks,128,124,4,Mavericks,Knicks,0
Los Angeles Lakers,Phoenix Suns,109,127,-18,Lakers,Suns,0
Atlanta Hawks,Indiana Pacers,108,126,-18,Hawks,Pacers,0
Detroit Pistons,Houston Rockets,110,112,-2,Pistons,Rockets,0
Philadelphia 76ers,Sacramento Kings,112,93,19,76ers,Kings,0
Memphis Grizzlies,LA Clippers,119,128,-9,Grizzlies,Clippers,0
San Antonio Spurs,Charlotte Hornets,135,99,36,Spurs,Hornets,0
Miami Heat,Orlando Magic,99,96,3,Heat,Magic,0
Minnesota Timberwolves,Portland Trail Blazers,116,93,23,Timberwolves,Blazers,0
Chicago Bulls,Golden State Warriors,131,140,-9,Bulls,Warriors,0
Utah Jazz,Toronto Raptors,145,113,32,Jazz,Raptors,0
Denver Nuggets,New Orleans Pelicans,125,113,12,Nuggets,Pelicans,0
Boston Celtics,Houston Rockets,145,113,32,Celtics,Rockets,0
Atlanta Hawks,Washington Wizards,99,127,-28,Hawks,Wizards,0
Oklahoma City Thunder,Orlando Magic,112,100,12,Thunder,Magic,0
Milwaukee Bucks,Golden State Warriors,129,118,11,Bucks,Warriors,0
Memphis Grizzlies,New York Knicks,94,106,-12,Grizzlies,Knicks,0
Dallas Mavericks,New Orleans Pelicans,108,118,-10,Mavericks,Pelicans,0
San Antonio Spurs,Chicago Bulls,116,122,-6,Spurs,Bulls,0
Utah Jazz,Los Angeles Lakers,132,125,7,Jazz,Lakers,0
Denver Nuggets,Indiana Pacers,117,109,8,Nuggets,Pacers,0
Miami Heat,Charlotte Hornets,104,87,17,Heat,Hornets,0
Milwaukee Bucks,Sacramento Kings,143,142,1,Bucks,Kings,0
Minnesota Timberwolves,LA Clippers,109,105,4,Timberwolves,Clippers,0
Portland Trail Blazers,Phoenix Suns,116,127,-11,Blazers,Suns,0
Philadelphia 76ers,Houston Rockets,124,115,9,76ers,Rockets,0
Dallas Mavericks,New Orleans Pelicans,125,120,5,Mavericks,Pelicans,0
Washington Wizards,Detroit Pistons,117,129,-12,Wizards,Pistons,0
New York Knicks,Orlando Magic,94,98,-4,Knicks,Magic,0
Atlanta Hawks,San Antonio Spurs,109,99,10,Hawks,Spurs,0
Memphis Grizzlies,Golden State Warriors,116,107,9,Grizzlies,Warriors,0
Cleveland Cavaliers,Chicago Bulls,109,91,18,Cavaliers,Bulls,0
Brooklyn Nets,Miami Heat,95,96,-1,Nets,Heat,0
Toronto Raptors,Boston Celtics,96,105,-9,Raptors,Celtics,0
Utah Jazz,Indiana Pacers,132,105,27,Jazz,Pacers,0
Los Angeles Lakers,Oklahoma City Thunder,112,105,7,Lakers,Thunder,0
Philadelphia 76ers,Denver Nuggets,126,121,5,76ers,Nuggets,0
Phoenix Suns,Sacramento Kings,119,117,2,Suns,Kings,0
LA Clippers,Oklahoma City Thunder,128,117,11,Clippers,Thunder,0
Detroit Pistons,Minnesota Timberwolves,117,124,-7,Pistons,Timberwolves,0
Cleveland Cavaliers,Milwaukee Bucks,135,95,40,Cavaliers,Bucks,0
New York Knicks,Houston Rockets,109,94,15,Knicks,Rockets,0
Toronto Raptors,Miami Heat,121,97,24,Raptors,Heat,0
Boston Celtics,San Antonio Spurs,117,98,19,Celtics,Spurs,0
Atlanta Hawks,Orlando Magic,106,104,2,Hawks,Magic,0
New Orleans Pelicans,Charlotte Hornets,132,112,20,Pelicans,Hornets,0
Los Angeles Lakers,Dallas Mavericks,127,110,17,Lakers,Mavericks,0
Utah Jazz,Golden State Warriors,N/A,N/A,#VALUE!,Jazz,Warriors,0
Portland Trail Blazers,Brooklyn Nets,105,103,2,Blazers,Nets,0
New York Knicks,Washington Wizards,113,109,4,Knicks,Wizards,0
Toronto Raptors,Chicago Bulls,110,116,-6,Raptors,Bulls,0
Utah Jazz,Oklahoma City Thunder,129,134,-5,Jazz,Thunder,0
Minnesota Timberwolves,Memphis Grizzlies,118,103,15,Timberwolves,Grizzlies,0
Sacramento Kings,Indiana Pacers,121,126,-5,Kings,Pacers,0
Charlotte Hornets,San Antonio Spurs,124,120,4,Hornets,Spurs,0
Orlando Magic,Philadelphia 76ers,109,124,-15,Magic,76ers,0
Boston Celtics,Denver Nuggets,100,102,-2,Celtics,Nuggets,0
New Orleans Pelicans,Phoenix Suns,109,123,-14,Pelicans,Suns,0
Miami Heat,Atlanta Hawks,108,109,-1,Heat,Hawks,0
Portland Trail Blazers,Indiana Pacers,118,115,3,Blazers,Pacers,0
Golden State Warriors,Dallas Mavericks,N/A,N/A,#VALUE!,Warriors,Mavericks,0
Los Angeles Lakers,Brooklyn Nets,112,130,-18,Lakers,Nets,0
Detroit Pistons,Milwaukee Bucks,135,141,-6,Pistons,Bucks,0
Washington Wizards,San Antonio Spurs,127,131,-4,Wizards,Spurs,0
Charlotte Hornets,Philadelphia 76ers,89,97,-8,Hornets,76ers,0
Atlanta Hawks,Cleveland Cavaliers,95,116,-21,Hawks,Cavaliers,0
New York Knicks,Toronto Raptors,126,100,26,Knicks,Raptors,0
Minnesota Timberwolves,Oklahoma City Thunder,97,102,-5,Timberwolves,Thunder,0
Chicago Bulls,Memphis Grizzlies,125,96,29,Bulls,Grizzlies,0
Houston Rockets,Utah Jazz,127,126,1,Rockets,Jazz,0
LA Clippers,Brooklyn Nets,125,114,11,Clippers,Nets,0
Orlando Magic,Miami Heat,105,87,18,Magic,Heat,0
Washington Wizards,Denver Nuggets,104,113,-9,Wizards,Nuggets,0
Houston Rockets,Boston Celtics,107,116,-9,Rockets,Celtics,0
Phoenix Suns,Indiana Pacers,117,110,7,Suns,Pacers,0
Los Angeles Lakers,Portland Trail Blazers,134,110,24,Lakers,Blazers,0
Detroit Pistons,Milwaukee Bucks,113,122,-9,Pistons,Bucks,0
Orlando Magic,Cleveland Cavaliers,99,126,-27,Magic,Cavaliers,0
Philadelphia 76ers,San Antonio Spurs,133,123,10,76ers,Spurs,0
Toronto Raptors,Memphis Grizzlies,100,108,-8,Raptors,Grizzlies,0
Minnesota Timberwolves,Charlotte Hornets,125,128,-3,Timberwolves,Hornets,0
Dallas Mavericks,Boston Celtics,110,119,-9,Mavericks,Celtics,0
Phoenix Suns,Chicago Bulls,115,113,2,Suns,Bulls,0
Sacramento Kings,Atlanta Hawks,122,107,15,Kings,Hawks,0
Indiana Pacers,Denver Nuggets,109,114,-5,Pacers,Nuggets,0
Brooklyn Nets,New York Knicks,103,108,-5,Nets,Knicks,0
Oklahoma City Thunder,Portland Trail Blazers,111,109,2,Thunder,Blazers,0
New Orleans Pelicans,Utah Jazz,153,124,29,Pelicans,Jazz,0
LA Clippers,Los Angeles Lakers,127,116,11,Clippers,Lakers,0
Washington Wizards,Minnesota Timberwolves,107,118,-11,Wizards,Timberwolves,0
Detroit Pistons,Charlotte Hornets,113,106,7,Pistons,Hornets,0
Miami Heat,Memphis Grizzlies,96,105,-9,Heat,Grizzlies,0
Houston Rockets,Portland Trail Blazers,131,137,-6,Rockets,Blazers,0
Milwaukee Bucks,Cleveland Cavaliers,126,116,10,Bucks,Cavaliers,0
Dallas Mavericks,Phoenix Suns,109,132,-23,Mavericks,Suns,0
San Antonio Spurs,Oklahoma City Thunder,114,140,-26,Spurs,Thunder,0
Golden State Warriors,Atlanta Hawks,134,112,22,Warriors,Hawks,0
Indiana Pacers,Philadelphia 76ers,134,122,12,Pacers,76ers,0
Washington Wizards,Utah Jazz,108,123,-15,Wizards,Jazz,0
Miami Heat,Boston Celtics,110,143,-33,Heat,Celtics,0
New York Knicks,Denver Nuggets,122,84,38,Knicks,Nuggets,0
Brooklyn Nets,Minnesota Timberwolves,94,96,-2,Nets,Timberwolves,0
Golden State Warriors,Sacramento Kings,133,134,-1,Warriors,Kings,0
Los Angeles Lakers,Chicago Bulls,141,132,9,Lakers,Bulls,0
Charlotte Hornets,Houston Rockets,104,138,-34,Hornets,Rockets,0
Indiana Pacers,Phoenix Suns,133,131,2,Pacers,Suns,0
Atlanta Hawks,Dallas Mavericks,143,148,-5,Hawks,Mavericks,0
Toronto Raptors,LA Clippers,107,127,-20,Raptors,Clippers,0
Memphis Grizzlies,Orlando Magic,107,106,1,Grizzlies,Magic,0
Milwaukee Bucks,Cleveland Cavaliers,100,112,-12,Bucks,Cavaliers,0
New Orleans Pelicans,Oklahoma City Thunder,83,107,-24,Pelicans,Thunder,0
San Antonio Spurs,Portland Trail Blazers,116,100,16,Spurs,Blazers,0
Detroit Pistons,Washington Wizards,104,118,-14,Pistons,Wizards,0
New York Knicks,Miami Heat,125,109,16,Knicks,Heat,0
Denver Nuggets,Philadelphia 76ers,111,105,6,Nuggets,76ers,0
Brooklyn Nets,Houston Rockets,106,104,2,Nets,Rockets,0
Charlotte Hornets,Utah Jazz,122,134,-12,Hornets,Jazz,0
Boston Celtics,LA Clippers,96,115,-19,Celtics,Clippers,0
Milwaukee Bucks,New Orleans Pelicans,141,117,24,Bucks,Pelicans,0
San Antonio Spurs,Minnesota Timberwolves,113,112,1,Spurs,Timberwolves,0
Golden State Warriors,Los Angeles Lakers,144,145,-1,Warriors,Lakers,0
Dallas Mavericks,Sacramento Kings,115,120,-5,Mavericks,Kings,0
Detroit Pistons,Oklahoma City Thunder,120,104,16,Pistons,Thunder,0
Indiana Pacers,Memphis Grizzlies,116,110,6,Pacers,Grizzlies,0
Atlanta Hawks,Toronto Raptors,126,125,1,Hawks,Raptors,0
Orlando Magic,Phoenix Suns,113,98,15,Magic,Suns,0
Portland Trail Blazers,Chicago Bulls,96,104,-8,Blazers,Bulls,0
Charlotte Hornets,New York Knicks,92,113,-21,Hornets,Knicks,0
Cleveland Cavaliers,LA Clippers,118,108,10,Cavaliers,Clippers,0
Miami Heat,Phoenix Suns,105,118,-13,Heat,Suns,0
Brooklyn Nets,Utah Jazz,147,114,33,Nets,Jazz,0
Boston Celtics,New Orleans Pelicans,118,112,6,Celtics,Pelicans,0
San Antonio Spurs,Washington Wizards,113,118,-5,Spurs,Wizards,0
Memphis Grizzlies,Sacramento Kings,94,103,-9,Grizzlies,Kings,0
Oklahoma City Thunder,Minnesota Timberwolves,101,107,-6,Thunder,Timberwolves,0
Houston Rockets,Los Angeles Lakers,135,119,16,Rockets,Lakers,0
Dallas Mavericks,Orlando Magic,131,129,2,Mavericks,Magic,0
Denver Nuggets,Milwaukee Bucks,113,107,6,Nuggets,Bucks,0
Portland Trail Blazers,Philadelphia 76ers,130,104,26,Blazers,76ers,0
New York Knicks,Utah Jazz,118,103,15,Knicks,Jazz,0
Atlanta Hawks,Los Angeles Lakers,138,122,16,Hawks,Lakers,0
Boston Celtics,Indiana Pacers,129,124,5,Celtics,Pacers,0
Chicago Bulls,Toronto Raptors,107,118,-11,Bulls,Raptors,0
Golden State Warriors,Philadelphia 76ers,119,107,12,Warriors,76ers,0
Charlotte Hornets,Chicago Bulls,110,117,-7,Hornets,Bulls,0
Washington Wizards,LA Clippers,109,125,-16,Wizards,Clippers,0
Cleveland Cavaliers,Detroit Pistons,128,121,7,Cavaliers,Pistons,0
Miami Heat,Sacramento Kings,115,106,9,Heat,Kings,0
Oklahoma City Thunder,Denver Nuggets,105,100,5,Thunder,Nuggets,0
Houston Rockets,New Orleans Pelicans,99,110,-11,Rockets,Pelicans,0
Minnesota Timberwolves,Dallas Mavericks,121,87,34,Timberwolves,Mavericks,0
San Antonio Spurs,Orlando Magic,98,108,-10,Spurs,Magic,0
Brooklyn Nets,Phoenix Suns,120,136,-16,Nets,Suns,0
Portland Trail Blazers,Milwaukee Bucks,119,116,3,Blazers,Bucks,0
New York Knicks,Indiana Pacers,109,105,4,Knicks,Pacers,0
Boston Celtics,Los Angeles Lakers,105,114,-9,Celtics,Lakers,0
Memphis Grizzlies,Cleveland Cavaliers,101,108,-7,Grizzlies,Cavaliers,0
Utah Jazz,Philadelphia 76ers,124,127,-3,Jazz,76ers,0
Detroit Pistons,LA Clippers,125,136,-11,Pistons,Clippers,0
Washington Wizards,Miami Heat,102,110,-8,Wizards,Heat,0
Indiana Pacers,Sacramento Kings,122,133,-11,Pacers,Kings,0
Atlanta Hawks,Phoenix Suns,129,120,9,Hawks,Suns,0
San Antonio Spurs,New Orleans Pelicans,113,114,-1,Spurs,Pelicans,0
Minnesota Timberwolves,Orlando Magic,106,108,-2,Timberwolves,Magic,0
Houston Rockets,Toronto Raptors,135,106,29,Rockets,Raptors,0
Memphis Grizzlies,Golden State Warriors,101,121,-20,Grizzlies,Warriors,0
Oklahoma City Thunder,Charlotte Hornets,126,106,20,Thunder,Hornets,0
Denver Nuggets,Portland Trail Blazers,120,108,12,Nuggets,Blazers,0
Philadelphia 76ers,Brooklyn Nets,121,136,-15,76ers,Nets,0
Atlanta Hawks,Golden State Warriors,141,134,7,Hawks,Warriors,0
Chicago Bulls,Sacramento Kings,115,123,-8,Bulls,Kings,0
Dallas Mavericks,Milwaukee Bucks,117,129,-12,Mavericks,Bucks,0
San Antonio Spurs,Cleveland Cavaliers,101,117,-16,Spurs,Cavaliers,0
New York Knicks,Los Angeles Lakers,105,113,-8,Knicks,Lakers,0
Detroit Pistons,Orlando Magic,99,111,-12,Pistons,Magic,0
Washington Wizards,Phoenix Suns,112,140,-28,Wizards,Suns,0
Boston Celtics,Memphis Grizzlies,131,91,40,Celtics,Grizzlies,0
Miami Heat,LA Clippers,95,103,-8,Heat,Clippers,0
Charlotte Hornets,Indiana Pacers,99,115,-16,Hornets,Pacers,0
Oklahoma City Thunder,Toronto Raptors,135,127,8,Thunder,Raptors,0
Minnesota Timberwolves,Houston Rockets,111,90,21,Timberwolves,Rockets,0
Utah Jazz,Milwaukee Bucks,123,108,15,Jazz,Bucks,0
Denver Nuggets,Portland Trail Blazers,112,103,9,Nuggets,Blazers,0
Philadelphia 76ers,Dallas Mavericks,102,118,-16,76ers,Mavericks,0
Cleveland Cavaliers,Sacramento Kings,136,110,26,Cavaliers,Kings,0
Charlotte Hornets,Los Angeles Lakers,118,124,-6,Hornets,Lakers,0
Atlanta Hawks,LA Clippers,144,149,-5,Hawks,Clippers,0
Brooklyn Nets,Golden State Warriors,98,109,-11,Nets,Warriors,0
New Orleans Pelicans,Toronto Raptors,138,100,38,Pelicans,Raptors,0
Indiana Pacers,Houston Rockets,132,129,3,Pacers,Rockets,0
Miami Heat,Orlando Magic,121,95,26,Heat,Magic,0
New York Knicks,Memphis Grizzlies,123,113,10,Knicks,Grizzlies,0
Brooklyn Nets,Dallas Mavericks,107,119,-12,Nets,Mavericks,0
Chicago Bulls,Minnesota Timberwolves,129,123,6,Bulls,Timberwolves,0
Utah Jazz,Oklahoma City Thunder,124,117,7,Jazz,Thunder,0
Phoenix Suns,Milwaukee Bucks,114,106,8,Suns,Bucks,0
Washington Wizards,Cleveland Cavaliers,106,114,-8,Wizards,Cavaliers,0
Charlotte Hornets,Toronto Raptors,117,123,-6,Hornets,Raptors,0
Miami Heat,San Antonio Spurs,116,104,12,Heat,Spurs,0
Philadelphia 76ers,Golden State Warriors,104,127,-23,76ers,Warriors,0
Boston Celtics,Atlanta Hawks,125,117,8,Celtics,Hawks,0
LA Clippers,New Orleans Pelicans,106,117,-11,Clippers,Pelicans,0
Sacramento Kings,Detroit Pistons,120,133,-13,Kings,Pistons,0
Indiana Pacers,Golden State Warriors,109,131,-22,Pacers,Warriors,0
Orlando Magic,San Antonio Spurs,127,111,16,Magic,Spurs,0
Brooklyn Nets,Cleveland Cavaliers,95,118,-23,Nets,Cavaliers,0
New York Knicks,Dallas Mavericks,108,122,-14,Knicks,Mavericks,0
Milwaukee Bucks,Minnesota Timberwolves,105,129,-24,Bucks,Timberwolves,0
Memphis Grizzlies,Chicago Bulls,110,118,-8,Grizzlies,Bulls,0
Phoenix Suns,Utah Jazz,129,115,14,Suns,Jazz,0
Portland Trail Blazers,Detroit Pistons,122,128,-6,Blazers,Pistons,0
Los Angeles Lakers,Denver Nuggets,106,114,-8,Lakers,Nuggets,0
Philadelphia 76ers,Atlanta Hawks,121,127,-6,76ers,Hawks,0
Toronto Raptors,Houston Rockets,107,104,3,Raptors,Rockets,0
Boston Celtics,Washington Wizards,133,129,4,Celtics,Wizards,0
Milwaukee Bucks,Charlotte Hornets,120,84,36,Bucks,Hornets,0
Sacramento Kings,Denver Nuggets,135,106,29,Kings,Nuggets,0
Los Angeles Lakers,New Orleans Pelicans,139,122,17,Lakers,Pelicans,0
Dallas Mavericks,Oklahoma City Thunder,146,111,35,Mavericks,Thunder,0
LA Clippers,Detroit Pistons,112,106,6,Clippers,Pistons,0
Brooklyn Nets,San Antonio Spurs,123,103,20,Nets,Spurs,0
Charlotte Hornets,Memphis Grizzlies,115,106,9,Hornets,Grizzlies,0
Orlando Magic,Chicago Bulls,114,108,6,Magic,Bulls,0
Washington Wizards,Philadelphia 76ers,113,119,-6,Wizards,76ers,0
Atlanta Hawks,Houston Rockets,122,113,9,Hawks,Rockets,0
New York Knicks,Indiana Pacers,111,125,-14,Knicks,Pacers,0
Toronto Raptors,Cleveland Cavaliers,95,119,-24,Raptors,Cavaliers,0
Golden State Warriors,Phoenix Suns,113,112,1,Warriors,Suns,0
Portland Trail Blazers,New Orleans Pelicans,84,93,-9,Blazers,Pelicans,0
Miami Heat,Boston Celtics,106,110,-4,Heat,Celtics,0
Oklahoma City Thunder,Sacramento Kings,127,113,14,Thunder,Kings,0
Charlotte Hornets,Indiana Pacers,111,102,9,Hornets,Pacers,0
Cleveland Cavaliers,Philadelphia 76ers,121,123,-2,Cavaliers,76ers,0
Atlanta Hawks,Chicago Bulls,126,136,-10,Hawks,Bulls,0
Toronto Raptors,San Antonio Spurs,99,122,-23,Raptors,Spurs,0
Milwaukee Bucks,Denver Nuggets,112,95,17,Bucks,Nuggets,0
Memphis Grizzlies,New Orleans Pelicans,87,96,-9,Grizzlies,Pelicans,0
Houston Rockets,New York Knicks,105,103,2,Rockets,Knicks,0
Dallas Mavericks,Washington Wizards,112,104,8,Mavericks,Wizards,0
Utah Jazz,Golden State Warriors,107,129,-22,Jazz,Warriors,0
LA Clippers,Minnesota Timberwolves,100,121,-21,Clippers,Timberwolves,0
Orlando Magic,Oklahoma City Thunder,113,127,-14,Magic,Thunder,0
Brooklyn Nets,Boston Celtics,110,118,-8,Nets,Celtics,0
Milwaukee Bucks,Miami Heat,97,123,-26,Bucks,Heat,0
Portland Trail Blazers,Minnesota Timberwolves,109,121,-12,Blazers,Timberwolves,0
Phoenix Suns,Sacramento Kings,130,125,5,Suns,Kings,0
Los Angeles Lakers,Detroit Pistons,125,111,14,Lakers,Pistons,0
Charlotte Hornets,Atlanta Hawks,122,99,23,Hornets,Hawks,0
Orlando Magic,New York Knicks,118,100,18,Magic,Knicks,0
Philadelphia 76ers,Miami Heat,104,109,-5,76ers,Heat,0
Cleveland Cavaliers,Chicago Bulls,108,105,3,Cavaliers,Bulls,0
Toronto Raptors,Indiana Pacers,125,127,-2,Raptors,Pacers,0
Boston Celtics,Brooklyn Nets,136,86,50,Celtics,Nets,0
Memphis Grizzlies,Houston Rockets,121,113,8,Grizzlies,Rockets,0
New Orleans Pelicans,Washington Wizards,133,126,7,Pelicans,Wizards,0
Dallas Mavericks,San Antonio Spurs,116,93,23,Mavericks,Spurs,0
Denver Nuggets,Sacramento Kings,98,102,-4,Nuggets,Kings,0
Phoenix Suns,Detroit Pistons,116,100,16,Suns,Pistons,0
Utah Jazz,Los Angeles Lakers,122,138,-16,Jazz,Lakers,0
Golden State Warriors,LA Clippers,125,130,-5,Warriors,Clippers,0
Memphis Grizzlies,Milwaukee Bucks,113,110,3,Grizzlies,Bucks,0
Utah Jazz,Golden State Warriors,137,140,-3,Jazz,Warriors,0
Portland Trail Blazers,Minnesota Timberwolves,91,128,-37,Blazers,Timberwolves,0
Indiana Pacers,Detroit Pistons,129,115,14,Pacers,Pistons,0
Toronto Raptors,Brooklyn Nets,121,93,28,Raptors,Nets,0
Philadelphia 76ers,New York Knicks,96,110,-14,76ers,Knicks,0
Cleveland Cavaliers,Orlando Magic,109,116,-7,Cavaliers,Magic,0
Dallas Mavericks,Phoenix Suns,123,113,10,Mavericks,Suns,0
Chicago Bulls,Boston Celtics,112,129,-17,Bulls,Celtics,0
Oklahoma City Thunder,LA Clippers,129,107,22,Thunder,Clippers,0
New Orleans Pelicans,Houston Rockets,127,105,22,Pelicans,Rockets,0
Utah Jazz,Charlotte Hornets,107,115,-8,Jazz,Hornets,0
Denver Nuggets,Washington Wizards,130,110,20,Nuggets,Wizards,0
Golden State Warriors,Los Angeles Lakers,128,110,18,Warriors,Lakers,0
Sacramento Kings,San Antonio Spurs,127,122,5,Kings,Spurs,0
Philadelphia 76ers,Cleveland Cavaliers,104,97,7,76ers,Cavaliers,0
Atlanta Hawks,Toronto Raptors,121,123,-2,Hawks,Raptors,0
New Orleans Pelicans,Miami Heat,95,106,-11,Pelicans,Heat,0
Memphis Grizzlies,LA Clippers,95,101,-6,Grizzlies,Clippers,0
Houston Rockets,Phoenix Suns,114,110,4,Rockets,Suns,0
Oklahoma City Thunder,Washington Wizards,147,106,41,Thunder,Wizards,0
Minnesota Timberwolves,Milwaukee Bucks,107,112,-5,Timberwolves,Bucks,0
Golden State Warriors,Charlotte Hornets,97,84,13,Warriors,Hornets,0
Portland Trail Blazers,Denver Nuggets,112,127,-15,Blazers,Nuggets,0
Los Angeles Lakers,San Antonio Spurs,123,118,5,Lakers,Spurs,0
Detroit Pistons,Orlando Magic,109,112,-3,Pistons,Magic,0
New York Knicks,Boston Celtics,102,116,-14,Knicks,Celtics,0
Minnesota Timberwolves,Brooklyn Nets,101,86,15,Timberwolves,Nets,0
Philadelphia 76ers,Milwaukee Bucks,98,119,-21,76ers,Bucks,0
Phoenix Suns,Los Angeles Lakers,123,113,10,Suns,Lakers,0
Indiana Pacers,Dallas Mavericks,133,111,22,Pacers,Mavericks,0
Washington Wizards,Cleveland Cavaliers,105,114,-9,Wizards,Cavaliers,0
Golden State Warriors,Denver Nuggets,103,119,-16,Warriors,Nuggets,0
Atlanta Hawks,Orlando Magic,109,92,17,Hawks,Magic,0
Houston Rockets,Oklahoma City Thunder,110,123,-13,Rockets,Thunder,0
New Orleans Pelicans,Chicago Bulls,106,114,-8,Pelicans,Bulls,0
Utah Jazz,San Antonio Spurs,128,109,19,Jazz,Spurs,0
Portland Trail Blazers,Charlotte Hornets,80,93,-13,Blazers,Hornets,0
LA Clippers,Sacramento Kings,107,123,-16,Clippers,Kings,0
Indiana Pacers,Toronto Raptors,122,130,-8,Pacers,Raptors,0
New York Knicks,Detroit Pistons,113,111,2,Knicks,Pistons,0
Memphis Grizzlies,Brooklyn Nets,86,111,-25,Grizzlies,Nets,0
Sacramento Kings,Miami Heat,110,121,-11,Kings,Heat,0
Washington Wizards,Golden State Warriors,112,123,-11,Wizards,Warriors,0
Cleveland Cavaliers,Dallas Mavericks,121,119,2,Cavaliers,Mavericks,0
Orlando Magic,Brooklyn Nets,108,81,27,Magic,Nets,0
New York Knicks,New Orleans Pelicans,92,115,-23,Knicks,Pelicans,0
Boston Celtics,Philadelphia 76ers,117,99,18,Celtics,76ers,0
Atlanta Hawks,Utah Jazz,124,97,27,Hawks,Jazz,0
Minnesota Timberwolves,San Antonio Spurs,114,105,9,Timberwolves,Spurs,0
Milwaukee Bucks,Charlotte Hornets,123,85,38,Bucks,Hornets,0
Chicago Bulls,Detroit Pistons,95,105,-10,Bulls,Pistons,0
Portland Trail Blazers,Miami Heat,96,106,-10,Blazers,Heat,0
Oklahoma City Thunder,Houston Rockets,112,95,17,Thunder,Rockets,0
Toronto Raptors,Dallas Mavericks,125,136,-11,Raptors,Mavericks,0
Indiana Pacers,New Orleans Pelicans,123,114,9,Pacers,Pelicans,0
Chicago Bulls,Cleveland Cavaliers,132,123,9,Bulls,Cavaliers,0
Minnesota Timberwolves,Memphis Grizzlies,110,101,9,Timberwolves,Grizzlies,0
Denver Nuggets,Sacramento Kings,117,96,21,Nuggets,Kings,0
LA Clippers,Los Angeles Lakers,112,116,-4,Clippers,Lakers,0
Charlotte Hornets,Milwaukee Bucks,99,111,-12,Hornets,Bucks,0
Orlando Magic,Utah Jazz,115,107,8,Magic,Jazz,0
Brooklyn Nets,Atlanta Hawks,124,97,27,Nets,Hawks,0
New York Knicks,Golden State Warriors,99,110,-11,Knicks,Warriors,0
San Antonio Spurs,Oklahoma City Thunder,132,118,14,Spurs,Thunder,0
Phoenix Suns,Houston Rockets,110,105,5,Suns,Rockets,0
Denver Nuggets,Miami Heat,103,97,6,Nuggets,Heat,0
Los Angeles Lakers,Washington Wizards,134,131,3,Lakers,Wizards,0
Philadelphia 76ers,Charlotte Hornets,121,114,7,76ers,Hornets,0
Detroit Pistons,Cleveland Cavaliers,100,110,-10,Pistons,Cavaliers,0
Boston Celtics,Dallas Mavericks,138,110,28,Celtics,Mavericks,0
Toronto Raptors,Golden State Warriors,105,120,-15,Raptors,Warriors,0
Memphis Grizzlies,Portland Trail Blazers,92,122,-30,Grizzlies,Blazers,0
New Orleans Pelicans,Indiana Pacers,129,102,27,Pelicans,Pacers,0
Minnesota Timberwolves,Sacramento Kings,120,124,-4,Timberwolves,Kings,0
Chicago Bulls,Milwaukee Bucks,97,113,-16,Bulls,Bucks,0
LA Clippers,Washington Wizards,140,115,25,Clippers,Wizards,0
Brooklyn Nets,Atlanta Hawks,114,102,12,Nets,Hawks,0
Miami Heat,Utah Jazz,126,120,6,Heat,Jazz,0
Memphis Grizzlies,Portland Trail Blazers,100,107,-7,Grizzlies,Blazers,0
Los Angeles Lakers,Denver Nuggets,114,124,-10,Lakers,Nuggets,0
Phoenix Suns,Houston Rockets,109,118,-9,Suns,Rockets,0
Dallas Mavericks,Philadelphia 76ers,116,120,-4,Mavericks,76ers,0
Boston Celtics,Golden State Warriors,140,88,52,Celtics,Warriors,0
Minnesota Timberwolves,LA Clippers,88,89,-1,Timberwolves,Clippers,0
Orlando Magic,Detroit Pistons,113,91,22,Magic,Pistons,0
Toronto Raptors,Charlotte Hornets,111,106,5,Raptors,Hornets,0
Cleveland Cavaliers,New York Knicks,98,107,-9,Cavaliers,Knicks,0
San Antonio Spurs,Indiana Pacers,117,105,12,Spurs,Pacers,0
Phoenix Suns,Oklahoma City Thunder,110,118,-8,Suns,Thunder,0
Brooklyn Nets,Memphis Grizzlies,102,106,-4,Nets,Grizzlies,0
Minnesota Timberwolves,Portland Trail Blazers,119,114,5,Timberwolves,Blazers,0
Milwaukee Bucks,LA Clippers,113,106,7,Bucks,Clippers,0
Utah Jazz,Washington Wizards,127,115,12,Jazz,Wizards,0
Sacramento Kings,Chicago Bulls,109,113,-4,Kings,Bulls,0
Los Angeles Lakers,Oklahoma City Thunder,116,104,12,Lakers,Thunder,0
Charlotte Hornets,Orlando Magic,89,101,-12,Hornets,Magic,0
Miami Heat,Detroit Pistons,118,110,8,Heat,Pistons,0
New York Knicks,Atlanta Hawks,100,116,-16,Knicks,Hawks,0
Brooklyn Nets,Philadelphia 76ers,112,107,5,Nets,76ers,0
Toronto Raptors,New Orleans Pelicans,98,139,-41,Raptors,Pelicans,0
Cleveland Cavaliers,Boston Celtics,105,104,1,Cavaliers,Celtics,0
Houston Rockets,San Antonio Spurs,114,101,13,Rockets,Spurs,0
Dallas Mavericks,Indiana Pacers,120,137,-17,Mavericks,Pacers,0
Denver Nuggets,Phoenix Suns,107,117,-10,Nuggets,Suns,0
Washington Wizards,Orlando Magic,109,119,-10,Wizards,Magic,0
Philadelphia 76ers,Memphis Grizzlies,109,115,-6,76ers,Grizzlies,0
Houston Rockets,LA Clippers,116,122,-6,Rockets,Clippers,0
Atlanta Hawks,Cleveland Cavaliers,112,101,11,Hawks,Cavaliers,0
Utah Jazz,Chicago Bulls,117,119,-2,Jazz,Bulls,0
Portland Trail Blazers,Oklahoma City Thunder,120,128,-8,Blazers,Thunder,0
Golden State Warriors,Milwaukee Bucks,125,90,35,Warriors,Bucks,0
Los Angeles Lakers,Sacramento Kings,120,130,-10,Lakers,Kings,0
Indiana Pacers,Minnesota Timberwolves,111,113,-2,Pacers,Timberwolves,0
Detroit Pistons,Brooklyn Nets,118,112,6,Pistons,Nets,0
Dallas Mavericks,Miami Heat,114,108,6,Mavericks,Heat,0
Phoenix Suns,Toronto Raptors,120,113,7,Suns,Raptors,0
Golden State Warriors,Chicago Bulls,122,125,-3,Warriors,Bulls,0
Denver Nuggets,Boston Celtics,115,109,6,Nuggets,Celtics,0
Sacramento Kings,San Antonio Spurs,131,129,2,Kings,Spurs,0
Philadelphia 76ers,New Orleans Pelicans,95,103,-8,76ers,Pelicans,0
Washington Wizards,Charlotte Hornets,112,100,12,Wizards,Hornets,0
Cleveland Cavaliers,Minnesota Timberwolves,113,104,9,Cavaliers,Timberwolves,0
New York Knicks,Orlando Magic,98,74,24,Knicks,Magic,0
Oklahoma City Thunder,Miami Heat,107,100,7,Thunder,Heat,0
Memphis Grizzlies,Atlanta Hawks,92,99,-7,Grizzlies,Hawks,0
Portland Trail Blazers,Houston Rockets,107,123,-16,Blazers,Rockets,0
Los Angeles Lakers,Milwaukee Bucks,123,122,1,Lakers,Bucks,0
LA Clippers,Chicago Bulls,112,102,10,Clippers,Bulls,0
Charlotte Hornets,Brooklyn Nets,110,99,11,Hornets,Nets,0
Detroit Pistons,Dallas Mavericks,124,142,-18,Pistons,Mavericks,0
Phoenix Suns,Boston Celtics,107,117,-10,Suns,Celtics,0
Golden State Warriors,San Antonio Spurs,113,126,-13,Warriors,Spurs,0
Denver Nuggets,Utah Jazz,142,121,21,Nuggets,Jazz,0
Portland Trail Blazers,Toronto Raptors,128,118,10,Blazers,Raptors,0
LA Clippers,Milwaukee Bucks,117,124,-7,Clippers,Bucks,0
Orlando Magic,Indiana Pacers,97,111,-14,Magic,Pacers,0
Miami Heat,Washington Wizards,108,110,-2,Heat,Wizards,0
Sacramento Kings,Houston Rockets,104,112,-8,Kings,Rockets,0
Atlanta Hawks,New Orleans Pelicans,103,116,-13,Hawks,Pelicans,0
Cleveland Cavaliers,Brooklyn Nets,101,120,-19,Cavaliers,Nets,0
Oklahoma City Thunder,Memphis Grizzlies,124,93,31,Thunder,Grizzlies,0
New York Knicks,Philadelphia 76ers,73,79,-6,Knicks,76ers,0
Los Angeles Lakers,Minnesota Timberwolves,120,109,11,Lakers,Timberwolves,0
Detroit Pistons,Charlotte Hornets,114,97,17,Pistons,Hornets,0
Cleveland Cavaliers,Phoenix Suns,111,117,-6,Cavaliers,Suns,0
San Antonio Spurs,Golden State Warriors,102,112,-10,Spurs,Warriors,0
Chicago Bulls,Dallas Mavericks,92,127,-35,Bulls,Mavericks,0
Denver Nuggets,Toronto Raptors,125,119,6,Nuggets,Raptors,0
Portland Trail Blazers,Boston Celtics,99,121,-22,Blazers,Celtics,0
New York Knicks,Philadelphia 76ers,106,79,27,Knicks,76ers,0
Memphis Grizzlies,Washington Wizards,109,97,12,Grizzlies,Wizards,0
Oklahoma City Thunder,Indiana Pacers,111,121,-10,Thunder,Pacers,0
San Antonio Spurs,Houston Rockets,101,103,-2,Spurs,Rockets,0
Utah Jazz,Boston Celtics,107,123,-16,Jazz,Celtics,0
LA Clippers,Minnesota Timberwolves,100,118,-18,Clippers,Timberwolves,0
Sacramento Kings,Milwaukee Bucks,129,94,35,Kings,Bucks,0
Orlando Magic,Brooklyn Nets,114,106,8,Magic,Nets,0
Detroit Pistons,Toronto Raptors,113,104,9,Pistons,Raptors,0
Miami Heat,Denver Nuggets,88,100,-12,Heat,Nuggets,0
Indiana Pacers,Chicago Bulls,129,132,-3,Pacers,Bulls,0
New Orleans Pelicans,Cleveland Cavaliers,95,116,-21,Pelicans,Cavaliers,0
Memphis Grizzlies,Charlotte Hornets,98,110,-12,Grizzlies,Hornets,0
Dallas Mavericks,Golden State Warriors,109,99,10,Mavericks,Warriors,0
Sacramento Kings,Los Angeles Lakers,120,107,13,Kings,Lakers,0
Portland Trail Blazers,Atlanta Hawks,106,102,4,Blazers,Hawks,0
Boston Celtics,Phoenix Suns,127,112,15,Celtics,Suns,0
Chicago Bulls,LA Clippers,111,126,-15,Bulls,Clippers,0
Houston Rockets,Washington Wizards,135,119,16,Rockets,Wizards,0
Milwaukee Bucks,Philadelphia 76ers,114,105,9,Bucks,76ers,0
Oklahoma City Thunder,Dallas Mavericks,126,119,7,Thunder,Mavericks,0
Portland Trail Blazers,New York Knicks,93,105,-12,Blazers,Knicks,0
Detroit Pistons,Miami Heat,95,108,-13,Pistons,Heat,0
Charlotte Hornets,Phoenix Suns,96,107,-11,Hornets,Suns,0
Toronto Raptors,Orlando Magic,103,113,-10,Raptors,Magic,0
New Orleans Pelicans,LA Clippers,112,104,8,Pelicans,Clippers,0
San Antonio Spurs,Denver Nuggets,106,117,-11,Spurs,Nuggets,0
Utah Jazz,Atlanta Hawks,124,122,2,Jazz,Hawks,0
Houston Rockets,Cleveland Cavaliers,117,103,14,Rockets,Cavaliers,0
New Orleans Pelicans,Portland Trail Blazers,126,107,19,Pelicans,Blazers,0
Philadelphia 76ers,Charlotte Hornets,109,98,11,76ers,Hornets,0
Indiana Pacers,Brooklyn Nets,121,100,21,Pacers,Nets,0
Chicago Bulls,Washington Wizards,127,98,29,Bulls,Wizards,0
Memphis Grizzlies,Oklahoma City Thunder,112,118,-6,Grizzlies,Thunder,0
Los Angeles Lakers,Golden State Warriors,121,128,-7,Lakers,Warriors,0
Utah Jazz,Minnesota Timberwolves,100,119,-19,Jazz,Timberwolves,0
Sacramento Kings,New York Knicks,91,98,-7,Kings,Knicks,0
Milwaukee Bucks,Phoenix Suns,140,129,11,Bucks,Suns,0
Detroit Pistons,Miami Heat,101,104,-3,Pistons,Heat,0
Dallas Mavericks,Denver Nuggets,107,105,2,Mavericks,Nuggets,0
Orlando Magic,Toronto Raptors,111,96,15,Magic,Raptors,0
Washington Wizards,Boston Celtics,104,130,-26,Wizards,Celtics,0
San Antonio Spurs,Brooklyn Nets,122,115,7,Spurs,Nets,0
LA Clippers,Atlanta Hawks,93,110,-17,Clippers,Hawks,0
Indiana Pacers,Cleveland Cavaliers,103,108,-5,Pacers,Cavaliers,0
Philadelphia 76ers,Miami Heat,98,91,7,76ers,Heat,0
Boston Celtics,Detroit Pistons,119,94,25,Celtics,Pistons,0
Chicago Bulls,Portland Trail Blazers,110,107,3,Bulls,Blazers,0
Utah Jazz,Minnesota Timberwolves,104,114,-10,Jazz,Timberwolves,0
Sacramento Kings,Memphis Grizzlies,121,111,10,Kings,Grizzlies,0
Golden State Warriors,New York Knicks,112,119,-7,Warriors,Knicks,0
Los Angeles Lakers,Atlanta Hawks,136,105,31,Lakers,Hawks,0
Washington Wizards,Houston Rockets,114,137,-23,Wizards,Rockets,0
Orlando Magic,Charlotte Hornets,112,92,20,Magic,Hornets,0
Brooklyn Nets,New Orleans Pelicans,91,104,-13,Nets,Pelicans,0
San Antonio Spurs,Dallas Mavericks,107,113,-6,Spurs,Mavericks,0
Minnesota Timberwolves,Denver Nuggets,112,115,-3,Timberwolves,Nuggets,0
Cleveland Cavaliers,Miami Heat,104,107,-3,Cavaliers,Heat,0
Detroit Pistons,Indiana Pacers,103,122,-19,Pistons,Pacers,0
Toronto Raptors,Sacramento Kings,89,123,-34,Raptors,Kings,0
Boston Celtics,Milwaukee Bucks,122,119,3,Celtics,Bucks,0
Oklahoma City Thunder,Utah Jazz,119,107,12,Thunder,Jazz,0
Portland Trail Blazers,LA Clippers,103,116,-13,Blazers,Clippers,0
Phoenix Suns,Philadelphia 76ers,115,102,13,Suns,76ers,0
Golden State Warriors,Memphis Grizzlies,137,116,21,Warriors,Grizzlies,0
Orlando Magic,New Orleans Pelicans,121,106,15,Magic,Pelicans,0
Washington Wizards,Sacramento Kings,109,102,7,Wizards,Kings,0
Milwaukee Bucks,Brooklyn Nets,115,108,7,Bucks,Nets,0
Houston Rockets,Chicago Bulls,127,117,10,Rockets,Bulls,0
Dallas Mavericks,Utah Jazz,113,97,16,Mavericks,Jazz,0
Denver Nuggets,New York Knicks,113,100,13,Nuggets,Knicks,0
Phoenix Suns,Atlanta Hawks,128,115,13,Suns,Hawks,0
Toronto Raptors,Oklahoma City Thunder,103,123,-20,Raptors,Thunder,0
Detroit Pistons,Boston Celtics,102,129,-27,Pistons,Celtics,0
Minnesota Timberwolves,Cleveland Cavaliers,104,91,13,Timberwolves,Cavaliers,0
San Antonio Spurs,Memphis Grizzlies,97,99,-2,Spurs,Grizzlies,0
Miami Heat,New Orleans Pelicans,88,111,-23,Heat,Pelicans,0
Portland Trail Blazers,LA Clippers,117,125,-8,Blazers,Clippers,0
Golden State Warriors,Indiana Pacers,111,123,-12,Warriors,Pacers,0
Los Angeles Lakers,Philadelphia 76ers,101,94,7,Lakers,76ers,0
New York Knicks,Brooklyn Nets,105,93,12,Knicks,Nets,0
Orlando Magic,Sacramento Kings,107,109,-2,Magic,Kings,0
Atlanta Hawks,Charlotte Hornets,132,91,41,Hawks,Hornets,0
Washington Wizards,Toronto Raptors,112,109,3,Wizards,Raptors,0
Chicago Bulls,Boston Celtics,113,124,-11,Bulls,Celtics,0
San Antonio Spurs,Phoenix Suns,106,131,-25,Spurs,Suns,0
Houston Rockets,Utah Jazz,147,119,28,Rockets,Jazz,0
Portland Trail Blazers,Denver Nuggets,111,114,-3,Blazers,Nuggets,0
Detroit Pistons,New Orleans Pelicans,101,114,-13,Pistons,Pelicans,0
LA Clippers,Philadelphia 76ers,107,121,-14,Clippers,76ers,0
Miami Heat,Cleveland Cavaliers,121,84,37,Heat,Cavaliers,0
Milwaukee Bucks,Oklahoma City Thunder,118,93,25,Bucks,Thunder,0
Minnesota Timberwolves,Golden State Warriors,114,110,4,Timberwolves,Warriors,0
Los Angeles Lakers,Indiana Pacers,150,145,5,Lakers,Pacers,0
Cleveland Cavaliers,Charlotte Hornets,115,92,23,Cavaliers,Hornets,0
Atlanta Hawks,Boston Celtics,120,118,2,Hawks,Celtics,0
New York Knicks,Detroit Pistons,124,99,25,Knicks,Pistons,0
Toronto Raptors,Brooklyn Nets,88,96,-8,Raptors,Nets,0
San Antonio Spurs,Phoenix Suns,104,102,2,Spurs,Suns,0
Houston Rockets,Portland Trail Blazers,110,92,18,Rockets,Blazers,0
Chicago Bulls,Washington Wizards,105,107,-2,Bulls,Wizards,0
Denver Nuggets,Memphis Grizzlies,128,103,25,Nuggets,Grizzlies,0
Utah Jazz,Dallas Mavericks,105,115,-10,Jazz,Mavericks,0
Sacramento Kings,Philadelphia 76ers,108,96,12,Kings,76ers,0
LA Clippers,Indiana Pacers,116,133,-17,Clippers,Pacers,0
Miami Heat,Golden State Warriors,92,113,-21,Heat,Warriors,0
Milwaukee Bucks,Los Angeles Lakers,124,128,-4,Bucks,Lakers,0
New Orleans Pelicans,Oklahoma City Thunder,112,119,-7,Pelicans,Thunder,0
Sacramento Kings,Dallas Mavericks,96,132,-36,Kings,Mavericks,0
Charlotte Hornets,Cleveland Cavaliers,118,111,7,Hornets,Cavaliers,0
Washington Wizards,Brooklyn Nets,119,122,-3,Wizards,Nets,0
Orlando Magic,Golden State Warriors,93,101,-8,Magic,Warriors,0
Toronto Raptors,New York Knicks,101,145,-44,Raptors,Knicks,0
Atlanta Hawks,Portland Trail Blazers,120,106,14,Hawks,Blazers,0
Philadelphia 76ers,LA Clippers,107,108,-1,76ers,Clippers,0
Chicago Bulls,Indiana Pacers,125,99,26,Bulls,Pacers,0
Minnesota Timberwolves,Detroit Pistons,106,91,15,Timberwolves,Pistons,0
Oklahoma City Thunder,Houston Rockets,126,132,-6,Thunder,Rockets,0
Memphis Grizzlies,Los Angeles Lakers,124,136,-12,Grizzlies,Lakers,0
Utah Jazz,San Antonio Spurs,111,118,-7,Jazz,Spurs,0
Denver Nuggets,Phoenix Suns,97,104,-7,Nuggets,Suns,0
Atlanta Hawks,Boston Celtics,123,122,1,Hawks,Celtics,0
New Orleans Pelicans,Milwaukee Bucks,107,100,7,Pelicans,Bucks,0
Washington Wizards,Detroit Pistons,87,96,-9,Wizards,Pistons,0
Orlando Magic,LA Clippers,97,100,-3,Magic,Clippers,0
Indiana Pacers,Los Angeles Lakers,109,90,19,Pacers,Lakers,0
Charlotte Hornets,Golden State Warriors,97,115,-18,Hornets,Warriors,0
Brooklyn Nets,Chicago Bulls,125,108,17,Nets,Bulls,0
Cleveland Cavaliers,Philadelphia 76ers,117,114,3,Cavaliers,76ers,0
Oklahoma City Thunder,Phoenix Suns,128,103,25,Thunder,Suns,0
Miami Heat,Portland Trail Blazers,142,82,60,Heat,Blazers,0
San Antonio Spurs,New York Knicks,130,126,4,Spurs,Knicks,0
Denver Nuggets,Minnesota Timberwolves,98,111,-13,Nuggets,Timberwolves,0
Utah Jazz,Houston Rockets,100,101,-1,Jazz,Rockets,0
Sacramento Kings,Dallas Mavericks,103,107,-4,Kings,Mavericks,0
New Orleans Pelicans,Boston Celtics,92,104,-12,Pelicans,Celtics,0
Orlando Magic,Memphis Grizzlies,118,88,30,Magic,Grizzlies,0
Atlanta Hawks,Milwaukee Bucks,113,122,-9,Hawks,Bucks,0
Denver Nuggets,Cleveland Cavaliers,130,101,29,Nuggets,Cavaliers,0
Toronto Raptors,Philadelphia 76ers,120,135,-15,Raptors,76ers,0
Washington Wizards,Miami Heat,107,119,-12,Wizards,Heat,0
Charlotte Hornets,LA Clippers,118,130,-12,Hornets,Clippers,0
Brooklyn Nets,Los Angeles Lakers,104,116,-12,Nets,Lakers,0
San Antonio Spurs,Golden State Warriors,113,117,-4,Spurs,Warriors,0
Houston Rockets,Dallas Mavericks,107,125,-18,Rockets,Mavericks,0
Minnesota Timberwolves,Chicago Bulls,101,109,-8,Timberwolves,Bulls,0
New York Knicks,Oklahoma City Thunder,112,113,-1,Knicks,Thunder,0
Sacramento Kings,Utah Jazz,127,106,21,Kings,Jazz,0
Indiana Pacers,Brooklyn Nets,133,111,22,Pacers,Nets,0
Charlotte Hornets,Boston Celtics,104,118,-14,Hornets,Celtics,0
Detroit Pistons,Memphis Grizzlies,108,110,-2,Pistons,Grizzlies,0
Orlando Magic,Portland Trail Blazers,104,103,1,Magic,Blazers,0
Chicago Bulls,Atlanta Hawks,101,113,-12,Bulls,Hawks,0
New Orleans Pelicans,Phoenix Suns,111,124,-13,Pelicans,Suns,0
Toronto Raptors,Los Angeles Lakers,111,128,-17,Raptors,Lakers,0
Washington Wizards,Milwaukee Bucks,117,113,4,Wizards,Bucks,0
Philadelphia 76ers,Oklahoma City Thunder,109,105,4,76ers,Thunder,0
Miami Heat,New York Knicks,109,99,10,Heat,Knicks,0
Minnesota Timberwolves,Houston Rockets,113,106,7,Timberwolves,Rockets,0
Utah Jazz,Cleveland Cavaliers,113,129,-16,Jazz,Cavaliers,0
Denver Nuggets,San Antonio Spurs,110,105,5,Nuggets,Spurs,0
Golden State Warriors,Dallas Mavericks,104,100,4,Warriors,Mavericks,0
Sacramento Kings,LA Clippers,109,95,14,Kings,Clippers,0
Charlotte Hornets,Portland Trail Blazers,86,89,-3,Hornets,Blazers,0
Washington Wizards,Los Angeles Lakers,120,125,-5,Wizards,Lakers,0
Atlanta Hawks,Detroit Pistons,121,113,8,Hawks,Pistons,0
Boston Celtics,Oklahoma City Thunder,135,100,35,Celtics,Thunder,0
Brooklyn Nets,Indiana Pacers,115,111,4,Nets,Pacers,0
New Orleans Pelicans,Orlando Magic,108,117,-9,Pelicans,Magic,0
Milwaukee Bucks,Memphis Grizzlies,101,111,-10,Bucks,Grizzlies,0
Minnesota Timberwolves,Toronto Raptors,133,85,48,Timberwolves,Raptors,0
Phoenix Suns,Cleveland Cavaliers,122,101,21,Suns,Cavaliers,0
Dallas Mavericks,Atlanta Hawks,109,95,14,Mavericks,Hawks,0
Miami Heat,Philadelphia 76ers,105,109,-4,Heat,76ers,0
New York Knicks,Sacramento Kings,120,109,11,Knicks,Kings,0
Houston Rockets,Golden State Warriors,110,133,-23,Rockets,Warriors,0
LA Clippers,Denver Nuggets,102,100,2,Clippers,Nuggets,0
Charlotte Hornets,Orlando Magic,124,115,9,Hornets,Magic,0
Washington Wizards,Portland Trail Blazers,102,108,-6,Wizards,Blazers,0
Indiana Pacers,Oklahoma City Thunder,126,112,14,Pacers,Thunder,0
Boston Celtics,Sacramento Kings,101,100,1,Celtics,Kings,0
New Orleans Pelicans,San Antonio Spurs,109,111,-2,Pelicans,Spurs,0
Memphis Grizzlies,Detroit Pistons,108,90,18,Grizzlies,Pistons,0
Houston Rockets,Miami Heat,104,119,-15,Rockets,Heat,0
Chicago Bulls,New York Knicks,108,100,8,Bulls,Knicks,0
Milwaukee Bucks,Toronto Raptors,111,117,-6,Bucks,Raptors,0
Dallas Mavericks,Golden State Warriors,108,106,2,Mavericks,Warriors,0
Phoenix Suns,Minnesota Timberwolves,97,87,10,Suns,Timberwolves,0
LA Clippers,Utah Jazz,131,102,29,Clippers,Jazz,0
Los Angeles Lakers,Cleveland Cavaliers,116,97,19,Lakers,Cavaliers,0
Brooklyn Nets,Detroit Pistons,113,103,10,Nets,Pistons,0
Memphis Grizzlies,Philadelphia 76ers,96,116,-20,Grizzlies,76ers,0
Denver Nuggets,Atlanta Hawks,142,110,32,Nuggets,Hawks,0
LA Clippers,Cleveland Cavaliers,120,118,2,Clippers,Cavaliers,0
Dallas Mavericks,Houston Rockets,147,136,11,Mavericks,Rockets,0
Indiana Pacers,Miami Heat,117,115,2,Pacers,Heat,0
Charlotte Hornets,Oklahoma City Thunder,118,121,-3,Hornets,Thunder,0
Phoenix Suns,New Orleans Pelicans,105,113,-8,Suns,Pelicans,0
Orlando Magic,Chicago Bulls,113,98,15,Magic,Bulls,0
Toronto Raptors,Washington Wizards,130,122,8,Raptors,Wizards,0
Boston Celtics,Portland Trail Blazers,124,107,17,Celtics,Blazers,0
Milwaukee Bucks,New York Knicks,109,122,-13,Bucks,Knicks,0
San Antonio Spurs,Philadelphia 76ers,126,133,-7,Spurs,76ers,0
Brooklyn Nets,Sacramento Kings,77,107,-30,Nets,Kings,0
Golden State Warriors,Utah Jazz,118,110,8,Warriors,Jazz,0
Los Angeles Lakers,Minnesota Timberwolves,117,127,-10,Lakers,Timberwolves,0
Philadelphia 76ers,Detroit Pistons,120,102,18,76ers,Pistons,0
Toronto Raptors,Indiana Pacers,123,140,-17,Raptors,Pacers,0
Charlotte Hornets,Dallas Mavericks,104,130,-26,Hornets,Mavericks,0
Milwaukee Bucks,Boston Celtics,104,91,13,Bucks,Celtics,0
Atlanta Hawks,Miami Heat,111,117,-6,Hawks,Heat,0
Minnesota Timberwolves,Washington Wizards,130,121,9,Timberwolves,Wizards,0
Chicago Bulls,New York Knicks,117,128,-11,Bulls,Knicks,0
Memphis Grizzlies,San Antonio Spurs,87,102,-15,Grizzlies,Spurs,0
Houston Rockets,Orlando Magic,118,106,12,Rockets,Magic,0
Oklahoma City Thunder,Sacramento Kings,112,105,7,Thunder,Kings,0
Utah Jazz,Denver Nuggets,95,111,-16,Jazz,Nuggets,0
Portland Trail Blazers,New Orleans Pelicans,100,110,-10,Blazers,Pelicans,0
Phoenix Suns,LA Clippers,92,105,-13,Suns,Clippers,0
Los Angeles Lakers,Golden State Warriors,120,134,-14,Lakers,Warriors,0
Cleveland Cavaliers,Memphis Grizzlies,110,98,12,Cavaliers,Grizzlies,0
Atlanta Hawks,Charlotte Hornets,114,115,-1,Hawks,Hornets,0
Miami Heat,Dallas Mavericks,92,111,-19,Heat,Mavericks,0
Brooklyn Nets,Toronto Raptors,106,102,4,Nets,Raptors,0
Oklahoma City Thunder,San Antonio Spurs,127,89,38,Thunder,Spurs,0
Milwaukee Bucks,Orlando Magic,117,99,18,Bucks,Magic,0
Denver Nuggets,Minnesota Timberwolves,116,107,9,Nuggets,Timberwolves,0
LA Clippers,Phoenix Suns,108,124,-16,Clippers,Suns,0
Detroit Pistons,Chicago Bulls,105,127,-22,Pistons,Bulls,0
Boston Celtics,New York Knicks,109,118,-9,Celtics,Knicks,0
Utah Jazz,Houston Rockets,124,121,3,Jazz,Rockets,0
Sacramento Kings,New Orleans Pelicans,123,135,-12,Kings,Pelicans,0
Portland Trail Blazers,Golden State Warriors,92,100,-8,Blazers,Warriors,0
Washington Wizards,Chicago Bulls,127,129,-2,Wizards,Bulls,0
Philadelphia 76ers,Orlando Magic,125,113,12,76ers,Magic,0
Boston Celtics,Charlotte Hornets,131,98,33,Celtics,Hornets,0
Cleveland Cavaliers,Indiana Pacers,129,120,9,Cavaliers,Pacers,0
New York Knicks,Brooklyn Nets,111,107,4,Knicks,Nets,0
Minnesota Timberwolves,Atlanta Hawks,109,106,3,Timberwolves,Hawks,0
San Antonio Spurs,Denver Nuggets,121,120,1,Spurs,Nuggets,0
Oklahoma City Thunder,Milwaukee Bucks,125,107,18,Thunder,Bucks,0
Miami Heat,Toronto Raptors,125,103,22,Heat,Raptors,0
Memphis Grizzlies,Los Angeles Lakers,120,123,-3,Grizzlies,Lakers,0
Dallas Mavericks,Detroit Pistons,89,107,-18,Mavericks,Pistons,0
Portland Trail Blazers,Houston Rockets,107,116,-9,Blazers,Rockets,0
Golden State Warriors,New Orleans Pelicans,109,114,-5,Warriors,Pelicans,0
Sacramento Kings,Phoenix Suns,107,108,-1,Kings,Suns,0
LA Clippers,Utah Jazz,109,110,-1,Clippers,Jazz,0
Cleveland Cavaliers,Charlotte Hornets,110,120,-10,Cavaliers,Hornets,0
Philadelphia 76ers,Brooklyn Nets,107,86,21,76ers,Nets,0
Indiana Pacers,Atlanta Hawks,157,115,42,Pacers,Hawks,0
Boston Celtics,Washington Wizards,132,122,10,Celtics,Wizards,0
Orlando Magic,Milwaukee Bucks,113,88,25,Magic,Bucks,0
Miami Heat,Toronto Raptors,118,103,15,Heat,Raptors,0
New York Knicks,Chicago Bulls,120,119,1,Knicks,Bulls,0
New Orleans Pelicans,Los Angeles Lakers,108,124,-16,Pelicans,Lakers,0
Memphis Grizzlies,Denver Nuggets,111,126,-15,Grizzlies,Nuggets,0
Sacramento Kings,Portland Trail Blazers,121,82,39,Kings,Blazers,0
Golden State Warriors,Utah Jazz,123,116,7,Warriors,Jazz,0
San Antonio Spurs,Detroit Pistons,123,95,28,Spurs,Pistons,0
Minnesota Timberwolves,Phoenix Suns,106,125,-19,Timberwolves,Suns,0
Oklahoma City Thunder,Dallas Mavericks,135,86,49,Thunder,Mavericks,0
LA Clippers,Houston Rockets,105,116,-11,Clippers,Rockets,0
New Orleans Pelicans,Los Angeles Lakers,106,110,-4,Pelicans,Lakers,0
Sacramento Kings,Golden State Warriors,118,94,24,Kings,Warriors,0
Philadelphia 76ers,Miami Heat,105,104,1,76ers,Heat,0
Chicago Bulls,Atlanta Hawks,131,116,15,Bulls,Hawks,0
Miami Heat,Chicago Bulls,112,91,21,Heat,Bulls,0
New Orleans Pelicans,Sacramento Kings,105,98,7,Pelicans,Kings,0
Cleveland Cavaliers,Orlando Magic,97,83,14,Cavaliers,Magic,0
Minnesota Timberwolves,Phoenix Suns,120,95,25,Timberwolves,Suns,0
New York Knicks,Philadelphia 76ers,111,104,7,Knicks,76ers,0
Denver Nuggets,Los Angeles Lakers,114,103,11,Nuggets,Lakers,0
Boston Celtics,Miami Heat,114,94,20,Celtics,Heat,0
LA Clippers,Dallas Mavericks,109,97,12,Clippers,Mavericks,0
Milwaukee Bucks,Indiana Pacers,109,94,15,Bucks,Pacers,0
Oklahoma City Thunder,New Orleans Pelicans,94,92,2,Thunder,Pelicans,0
Cleveland Cavaliers,Orlando Magic,96,86,10,Cavaliers,Magic,0
New York Knicks,Philadelphia 76ers,104,101,3,Knicks,76ers,0
Denver Nuggets,Los Angeles Lakers,101,99,2,Nuggets,Lakers,0
Minnesota Timberwolves,Phoenix Suns,105,93,12,Timberwolves,Suns,0
Milwaukee Bucks,Indiana Pacers,108,125,-17,Bucks,Pacers,0
LA Clippers,Dallas Mavericks,93,96,-3,Clippers,Mavericks,0
Boston Celtics,Miami Heat,101,111,-10,Celtics,Heat,0
Oklahoma City Thunder,New Orleans Pelicans,124,92,32,Thunder,Pelicans,0
Orlando Magic,Cleveland Cavaliers,121,83,38,Magic,Cavaliers,0
Philadelphia 76ers,New York Knicks,125,114,11,76ers,Knicks,0
Los Angeles Lakers,Denver Nuggets,105,112,-7,Lakers,Nuggets,0
Indiana Pacers,Milwaukee Bucks,121,118,3,Pacers,Bucks,0
Dallas Mavericks,LA Clippers,101,90,11,Mavericks,Clippers,0
Phoenix Suns,Minnesota Timberwolves,109,126,-17,Suns,Timberwolves,0
Orlando Magic,Cleveland Cavaliers,112,89,23,Magic,Cavaliers,0
New Orleans Pelicans,Oklahoma City Thunder,85,106,-21,Pelicans,Thunder,0
Miami Heat,Boston Celtics,84,104,-20,Heat,Celtics,0
Los Angeles Lakers,Denver Nuggets,119,108,11,Lakers,Nuggets,0
Philadelphia 76ers,New York Knicks,92,97,-5,76ers,Knicks,0
Dallas Mavericks,LA Clippers,111,116,-5,Mavericks,Clippers,0
Indiana Pacers,Milwaukee Bucks,126,113,13,Pacers,Bucks,0
Phoenix Suns,Minnesota Timberwolves,116,122,-6,Suns,Timberwolves,0
Miami Heat,Boston Celtics,88,102,-14,Heat,Celtics,0
New Orleans Pelicans,Oklahoma City Thunder,89,97,-8,Pelicans,Thunder,0
Denver Nuggets,Los Angeles Lakers,108,106,2,Nuggets,Lakers,0
Minnesota Timberwolves,Phoenix Suns,N/A,N/A,#VALUE!,Timberwolves,Suns,0
New York Knicks,Philadelphia 76ers,106,112,-6,Knicks,76ers,0
Cleveland Cavaliers,Orlando Magic,104,103,1,Cavaliers,Magic,0
Milwaukee Bucks,Indiana Pacers,115,92,23,Bucks,Pacers,0
Boston Celtics,Miami Heat,118,84,34,Celtics,Heat,0
Oklahoma City Thunder,New Orleans Pelicans,N/A,N/A,#VALUE!,Thunder,Pelicans,0
LA Clippers,Dallas Mavericks,93,123,-30,Clippers,Mavericks,0
Los Angeles Lakers,Denver Nuggets,N/A,N/A,#VALUE!,Lakers,Nuggets,0
Phoenix Suns,Minnesota Timberwolves,N/A,N/A,#VALUE!,Suns,Timberwolves,0
Indiana Pacers,Milwaukee Bucks,120,98,22,Pacers,Bucks,0
Philadelphia 76ers,New York Knicks,115,118,-3,76ers,Knicks,0
New Orleans Pelicans,Oklahoma City Thunder,N/A,N/A,#VALUE!,Pelicans,Thunder,0
Miami Heat,Boston Celtics,N/A,N/A,#VALUE!,Heat,Celtics,0
Orlando Magic,Cleveland Cavaliers,103,96,7,Magic,Cavaliers,0
Dallas Mavericks,LA Clippers,114,101,13,Mavericks,Clippers,0
Denver Nuggets,Los Angeles Lakers,N/A,N/A,#VALUE!,Nuggets,Lakers,0
Minnesota Timberwolves,Phoenix Suns,N/A,N/A,#VALUE!,Timberwolves,Suns,0
Milwaukee Bucks,Indiana Pacers,N/A,N/A,#VALUE!,Bucks,Pacers,0
Denver Nuggets,Minnesota Timberwolves,99,106,-7,Nuggets,Timberwolves,0
New York Knicks,Philadelphia 76ers,N/A,N/A,#VALUE!,Knicks,76ers,0
Oklahoma City Thunder,New Orleans Pelicans,N/A,N/A,#VALUE!,Thunder,Pelicans,0
Boston Celtics,Miami Heat,N/A,N/A,#VALUE!,Celtics,Heat,0
Cleveland Cavaliers,Orlando Magic,106,94,12,Cavaliers,Magic,0
LA Clippers,Dallas Mavericks,N/A,N/A,#VALUE!,Clippers,Mavericks,0
New York Knicks,Indiana Pacers,121,117,4,Knicks,Pacers,0
Denver Nuggets,Minnesota Timberwolves,80,106,-26,Nuggets,Timberwolves,0
Boston Celtics,Cleveland Cavaliers,120,95,25,Celtics,Cavaliers,0
Oklahoma City Thunder,Dallas Mavericks,117,95,22,Thunder,Mavericks,0
New York Knicks,Indiana Pacers,130,121,9,Knicks,Pacers,0
Boston Celtics,Cleveland Cavaliers,94,118,-24,Celtics,Cavaliers,0
Oklahoma City Thunder,Dallas Mavericks,110,119,-9,Thunder,Mavericks,0
Indiana Pacers,New York Knicks,111,106,5,Pacers,Knicks,0
Minnesota Timberwolves,Denver Nuggets,90,117,-27,Timberwolves,Nuggets,0
Dallas Mavericks,Oklahoma City Thunder,105,101,4,Mavericks,Thunder,0
Cleveland Cavaliers,Boston Celtics,93,106,-13,Cavaliers,Celtics,0
Indiana Pacers,New York Knicks,121,89,32,Pacers,Knicks,0
Minnesota Timberwolves,Denver Nuggets,107,115,-8,Timberwolves,Nuggets,0
Cleveland Cavaliers,Boston Celtics,102,109,-7,Cavaliers,Celtics,0
Dallas Mavericks,Oklahoma City Thunder,96,100,-4,Mavericks,Thunder,0
New York Knicks,Indiana Pacers,121,91,30,Knicks,Pacers,0
Denver Nuggets,Minnesota Timberwolves,112,97,15,Nuggets,Timberwolves,0
Boston Celtics,Cleveland Cavaliers,113,98,15,Celtics,Cavaliers,0
Oklahoma City Thunder,Dallas Mavericks,92,104,-12,Thunder,Mavericks,0
Minnesota Timberwolves,Denver Nuggets,115,70,45,Timberwolves,Nuggets,0
Indiana Pacers,New York Knicks,116,103,13,Pacers,Knicks,0
Cleveland Cavaliers,Boston Celtics,N/A,N/A,#VALUE!,Cavaliers,Celtics,0
Dallas Mavericks,Oklahoma City Thunder,117,116,1,Mavericks,Thunder,0
Boston Celtics,Cleveland Cavaliers,N/A,N/A,#VALUE!,Celtics,Cavaliers,0
New York Knicks,Indiana Pacers,109,130,-21,Knicks,Pacers,0
Denver Nuggets,Minnesota Timberwolves,90,98,-8,Nuggets,Timberwolves,0
Oklahoma City Thunder,Dallas Mavericks,N/A,N/A,#VALUE!,Thunder,Mavericks,0
Boston Celtics,Indiana Pacers,133,128,5,Celtics,Pacers,0
Minnesota Timberwolves,Dallas Mavericks,105,108,-3,Timberwolves,Mavericks,0
Boston Celtics,Indiana Pacers,126,110,16,Celtics,Pacers,0
Minnesota Timberwolves,Dallas Mavericks,108,109,-1,Timberwolves,Mavericks,0
Indiana Pacers,Boston Celtics,111,114,-3,Pacers,Celtics,0
Dallas Mavericks,Minnesota Timberwolves,116,107,9,Mavericks,Timberwolves,0
Indiana Pacers,Boston Celtics,102,105,-3,Pacers,Celtics,0
Dallas Mavericks,Minnesota Timberwolves,100,105,-5,Mavericks,Timberwolves,0
Boston Celtics,Indiana Pacers,N/A,N/A,#VALUE!,Celtics,Pacers,0
Minnesota Timberwolves,Dallas Mavericks,103,124,-21,Timberwolves,Mavericks,0
Indiana Pacers,Boston Celtics,N/A,N/A,#VALUE!,Pacers,Celtics,0
Dallas Mavericks,Minnesota Timberwolves,N/A,N/A,#VALUE!,Mavericks,Timberwolves,0
Boston Celtics,Indiana Pacers,N/A,N/A,#VALUE!,Celtics,Pacers,0
Minnesota Timberwolves,Dallas Mavericks,N/A,N/A,#VALUE!,Timberwolves,Mavericks,0
Boston Celtics,Dallas Mavericks,107,89,18,Celtics,Mavericks,0
Boston Celtics,Dallas Mavericks,105,98,7,Celtics,Mavericks,0
Dallas Mavericks,Boston Celtics,99,106,-7,Mavericks,Celtics,0
Dallas Mavericks,Boston Celtics,122,84,38,Mavericks,Celtics,0
Boston Celtics,Dallas Mavericks,106,88,18,Celtics,Mavericks,0
Dallas Mavericks,Boston Celtics,N/A,N/A,#VALUE!,Mavericks,Celtics,0
Boston Celtics,Dallas Mavericks,N/A,N/A,#VALUE!,Celtics,Mavericks,0
Denver Nuggets,Boston Celtics,103,107,-4,Nuggets,Celtics,0
Utah Jazz,New Zealand Breakers,116,87,29,Jazz,Breakers,0
Los Angeles Lakers,Minnesota Timberwolves,107,124,-17,Lakers,Timberwolves,0
LA Clippers,Golden State Warriors,90,91,-1,Clippers,Warriors,0
Boston Celtics,Denver Nuggets,130,104,26,Celtics,Nuggets,0
Charlotte Hornets,New York Knicks,109,111,-2,Hornets,Knicks,0
Toronto Raptors,Washington Wizards,125,98,27,Raptors,Wizards,0
Detroit Pistons,Milwaukee Bucks,120,87,33,Pistons,Bucks,0
Los Angeles Lakers,Phoenix Suns,114,118,-4,Lakers,Suns,0
New Orleans Pelicans,Orlando Magic,106,104,2,Pelicans,Magic,0
Philadelphia 76ers,New Zealand Breakers,139,84,55,76ers,Breakers,0
San Antonio Spurs,Oklahoma City Thunder,107,112,-5,Spurs,Thunder,0
Dallas Mavericks,Memphis Grizzlies,116,121,-5,Mavericks,Grizzlies,0
Utah Jazz,Houston Rockets,122,113,9,Jazz,Rockets,0
Cleveland Cavaliers,Chicago Bulls,112,116,-4,Cavaliers,Bulls,0
Charlotte Hornets,Miami Heat,111,108,3,Hornets,Heat,0
Detroit Pistons,Phoenix Suns,97,105,-8,Pistons,Suns,0
Atlanta Hawks,Indiana Pacers,131,130,1,Hawks,Pacers,0
LA Clippers,Brooklyn Nets,115,106,9,Clippers,Nets,0
New York Knicks,Washington Wizards,117,94,23,Knicks,Wizards,0
San Antonio Spurs,Orlando Magic,107,97,10,Spurs,Magic,0
Oklahoma City Thunder,Houston Rockets,113,122,-9,Thunder,Rockets,0
Sacramento Kings,Golden State Warriors,112,122,-10,Kings,Warriors,0
Cleveland Cavaliers,Indiana Pacers,117,129,-12,Cavaliers,Pacers,0
Dallas Mavericks,Utah Jazz,102,107,-5,Mavericks,Jazz,0
Memphis Grizzlies,Charlotte Hornets,94,119,-25,Grizzlies,Hornets,0
Milwaukee Bucks,Los Angeles Lakers,102,107,-5,Bucks,Lakers,0
Oklahoma City Thunder,New Zealand Breakers,117,89,28,Thunder,Breakers,0
Orlando Magic,New Orleans Pelicans,N/A,N/A,#VALUE!,Magic,Pelicans,0
Washington Wizards,Toronto Raptors,113,95,18,Wizards,Raptors,0
Minnesota Timberwolves,Philadelphia 76ers,121,111,10,Timberwolves,76ers,0
Golden State Warriors,Sacramento Kings,109,106,3,Warriors,Kings,0
Phoenix Suns,Detroit Pistons,91,109,-18,Suns,Pistons,0
LA Clippers,Portland Trail Blazers,101,99,2,Clippers,Blazers,0
Chicago Bulls,Memphis Grizzlies,121,124,-3,Bulls,Grizzlies,0
Boston Celtics,Philadelphia 76ers,139,89,50,Celtics,76ers,0
San Antonio Spurs,Utah Jazz,126,120,6,Spurs,Jazz,0
Miami Heat,New Orleans Pelicans,101,99,2,Heat,Pelicans,0
Sacramento Kings,Portland Trail Blazers,85,105,-20,Kings,Blazers,0
New York Knicks,Minnesota Timberwolves,115,110,5,Knicks,Timberwolves,0
Boston Celtics,Toronto Raptors,115,111,4,Celtics,Raptors,0
Denver Nuggets,Phoenix Suns,114,118,-4,Nuggets,Suns,0
Golden State Warriors,Detroit Pistons,111,93,18,Warriors,Pistons,0
Indiana Pacers,Memphis Grizzlies,116,120,-4,Pacers,Grizzlies,0
Brooklyn Nets,Washington Wizards,131,92,39,Nets,Wizards,0
Atlanta Hawks,Philadelphia 76ers,89,104,-15,Hawks,76ers,0
Milwaukee Bucks,Chicago Bulls,111,107,4,Bucks,Bulls,0
LA Clippers,Dallas Mavericks,110,96,14,Clippers,Mavericks,0
Toronto Raptors,Boston Celtics,119,118,1,Raptors,Celtics,0
Miami Heat,San Antonio Spurs,120,117,3,Heat,Spurs,0
New York Knicks,Charlotte Hornets,111,105,6,Knicks,Hornets,0
Houston Rockets,New Orleans Pelicans,118,98,20,Rockets,Pelicans,0
Denver Nuggets,Oklahoma City Thunder,94,124,-30,Nuggets,Thunder,0
Utah Jazz,Sacramento Kings,117,114,3,Jazz,Kings,0
Los Angeles Lakers,Golden State Warriors,97,111,-14,Lakers,Warriors,0
Philadelphia 76ers,Brooklyn Nets,117,95,22,76ers,Nets,0
Detroit Pistons,Cleveland Cavaliers,108,92,16,Pistons,Cavaliers,0
Miami Heat,Atlanta Hawks,120,111,9,Heat,Hawks,0
Chicago Bulls,Minnesota Timberwolves,125,123,2,Bulls,Timberwolves,0
Portland Trail Blazers,Ulm Ratiopharm,111,100,11,Blazers,Ratiopharm,0
Indiana Pacers,Charlotte Hornets,121,116,5,Pacers,Hornets,0
Dallas Mavericks,Milwaukee Bucks,109,84,25,Mavericks,Bucks,0
Oklahoma City Thunder,Atlanta Hawks,104,99,5,Thunder,Hawks,0
Minnesota Timberwolves,Denver Nuggets,126,132,-6,Timberwolves,Nuggets,0
Houston Rockets,San Antonio Spurs,129,107,22,Rockets,Spurs,0
Phoenix Suns,Los Angeles Lakers,122,128,-6,Suns,Lakers,0
LA Clippers,Sacramento Kings,113,91,22,Clippers,Kings,0
Washington Wizards,New York Knicks,118,117,1,Wizards,Knicks,0
Orlando Magic,Philadelphia 76ers,114,99,15,Magic,76ers,0
Brooklyn Nets,Toronto Raptors,112,116,-4,Nets,Raptors,0
Chicago Bulls,Cleveland Cavaliers,139,137,2,Bulls,Cavaliers,0
Memphis Grizzlies,Miami Heat,109,114,-5,Grizzlies,Heat,0
Portland Trail Blazers,Utah Jazz,124,86,38,Blazers,Jazz,0
Golden State Warriors,Los Angeles Lakers,132,74,58,Warriors,Lakers,0
Boston Celtics,New York Knicks,132,109,23,Celtics,Knicks,0
Los Angeles Lakers,Minnesota Timberwolves,110,103,7,Lakers,Timberwolves,0
Detroit Pistons,Indiana Pacers,109,115,-6,Pistons,Pacers,0
Atlanta Hawks,Brooklyn Nets,120,116,4,Hawks,Nets,0
Miami Heat,Orlando Magic,97,116,-19,Heat,Magic,0
Philadelphia 76ers,Milwaukee Bucks,109,124,-15,76ers,Bucks,0
Toronto Raptors,Cleveland Cavaliers,106,136,-30,Raptors,Cavaliers,0
Houston Rockets,Charlotte Hornets,105,110,-5,Rockets,Hornets,0
New Orleans Pelicans,Chicago Bulls,123,111,12,Pelicans,Bulls,0
Utah Jazz,Memphis Grizzlies,124,126,-2,Jazz,Grizzlies,0
LA Clippers,Phoenix Suns,113,116,-3,Clippers,Suns,0
Portland Trail Blazers,Golden State Warriors,104,140,-36,Blazers,Warriors,0
Washington Wizards,Boston Celtics,102,122,-20,Wizards,Celtics,0
Dallas Mavericks,San Antonio Spurs,120,109,11,Mavericks,Spurs,0
